,occupied,unit_type,units,unoccupied,vacancy_rate,year,zip
0,8330,Total Units,9301,971,0.1044,2050,91901
1,4763,Single Family - Detached,5411,648,0.11976,2012,91901
2,1290,Multifamily,767,-523,-0.68188,2012,91901
3,234,Mobile Home,254,20,0.07874,2012,91901
4,6287,Total Units,6432,145,0.02254,2012,91901
5,5348,Single Family - Detached,6127,779,0.12714,2020,91901
6,766,Multifamily,766,0,0.0,2020,91901
7,234,Mobile Home,254,20,0.07874,2020,91901
8,6348,Total Units,7147,799,0.1118,2020,91901
9,5923,Single Family - Detached,6623,700,0.10569,2025,91901
10,738,Multifamily,738,0,0.0,2025,91901
11,234,Mobile Home,254,20,0.07874,2025,91901
12,6895,Total Units,7615,720,0.09455,2025,91901
13,6315,Single Family - Detached,7079,764,0.10792,2030,91901
14,703,Multifamily,704,1,0.00142,2030,91901
15,233,Mobile Home,254,21,0.08268,2030,91901
16,7251,Total Units,8037,786,0.0978,2030,91901
17,6764,Single Family - Detached,7513,749,0.09969,2035,91901
18,665,Multifamily,665,0,0.0,2035,91901
19,233,Mobile Home,254,21,0.08268,2035,91901
20,7662,Total Units,8432,770,0.09132,2035,91901
21,6808,Single Family - Detached,7618,810,0.10633,2040,91901
22,726,Multifamily,729,3,0.00412,2040,91901
23,234,Mobile Home,254,20,0.07874,2040,91901
24,7768,Total Units,8601,833,0.09685,2040,91901
25,6856,Single Family - Detached,7757,901,0.11615,2045,91901
26,948,Multifamily,953,5,0.00525,2045,91901
27,233,Mobile Home,254,21,0.08268,2045,91901
28,8037,Total Units,8964,927,0.10341,2045,91901
29,6955,Single Family - Detached,7896,941,0.11917,2050,91901
30,1150,Multifamily,1157,7,0.00605,2050,91901
31,225,Mobile Home,248,23,0.09274,2050,91901
32,6493,Total Units,6752,259,0.03836,2045,91902
33,4999,Single Family - Detached,5209,210,0.04031,2012,91902
34,784,Multifamily,793,9,0.01135,2012,91902
35,0,Mobile Home,0,0,,2012,91902
36,5783,Total Units,6002,219,0.03649,2012,91902
37,5134,Single Family - Detached,5372,238,0.0443,2020,91902
38,781,Multifamily,789,8,0.01014,2020,91902
39,0,Mobile Home,0,0,,2020,91902
40,5915,Total Units,6161,246,0.03993,2020,91902
41,5231,Single Family - Detached,5441,210,0.0386,2025,91902
42,765,Multifamily,773,8,0.01035,2025,91902
43,0,Mobile Home,0,0,,2025,91902
44,5996,Total Units,6214,218,0.03508,2025,91902
45,5321,Single Family - Detached,5518,197,0.0357,2030,91902
46,765,Multifamily,773,8,0.01035,2030,91902
47,0,Mobile Home,0,0,,2030,91902
48,6086,Total Units,6291,205,0.03259,2030,91902
49,5326,Single Family - Detached,5518,192,0.0348,2035,91902
50,765,Multifamily,773,8,0.01035,2035,91902
51,0,Mobile Home,0,0,,2035,91902
52,6091,Total Units,6291,200,0.03179,2035,91902
53,5210,Single Family - Detached,5436,226,0.04157,2040,91902
54,1107,Multifamily,1118,11,0.00984,2040,91902
55,0,Mobile Home,0,0,,2040,91902
56,6317,Total Units,6554,237,0.03616,2040,91902
57,5142,Single Family - Detached,5388,246,0.04566,2045,91902
58,1351,Multifamily,1364,13,0.00953,2045,91902
59,0,Mobile Home,0,0,,2045,91902
60,5166,Single Family - Detached,5420,254,0.04686,2050,91902
61,1350,Multifamily,1364,14,0.01026,2050,91902
62,0,Mobile Home,0,0,,2050,91902
63,6516,Total Units,6784,268,0.0395,2050,91902
64,583,Single Family - Detached,672,89,0.13244,2012,91905
65,35,Multifamily,38,3,0.07895,2012,91905
66,24,Mobile Home,27,3,0.11111,2012,91905
67,642,Total Units,737,95,0.1289,2012,91905
68,639,Single Family - Detached,754,115,0.15252,2020,91905
69,38,Multifamily,38,0,0.0,2020,91905
70,25,Mobile Home,27,2,0.07407,2020,91905
71,702,Total Units,819,117,0.14286,2020,91905
72,685,Single Family - Detached,784,99,0.12628,2025,91905
73,38,Multifamily,38,0,0.0,2025,91905
74,24,Mobile Home,27,3,0.11111,2025,91905
75,747,Total Units,849,102,0.12014,2025,91905
76,736,Single Family - Detached,846,110,0.13002,2030,91905
77,38,Multifamily,38,0,0.0,2030,91905
78,24,Mobile Home,27,3,0.11111,2030,91905
79,798,Total Units,911,113,0.12404,2030,91905
80,745,Single Family - Detached,849,104,0.1225,2035,91905
81,38,Multifamily,38,0,0.0,2035,91905
82,25,Mobile Home,27,2,0.07407,2035,91905
83,808,Total Units,914,106,0.11597,2035,91905
84,757,Single Family - Detached,861,104,0.12079,2040,91905
85,38,Multifamily,38,0,0.0,2040,91905
86,25,Mobile Home,27,2,0.07407,2040,91905
87,820,Total Units,926,106,0.11447,2040,91905
88,752,Single Family - Detached,863,111,0.12862,2045,91905
89,38,Multifamily,38,0,0.0,2045,91905
90,25,Mobile Home,27,2,0.07407,2045,91905
91,815,Total Units,928,113,0.12177,2045,91905
92,750,Single Family - Detached,865,115,0.13295,2050,91905
93,38,Multifamily,38,0,0.0,2050,91905
94,24,Mobile Home,27,3,0.11111,2050,91905
95,812,Total Units,930,118,0.12688,2050,91905
96,1258,Single Family - Detached,1278,20,0.01565,2012,91906
97,65,Multifamily,69,4,0.05797,2012,91906
98,45,Mobile Home,45,0,0.0,2012,91906
99,1368,Total Units,1392,24,0.01724,2012,91906
100,1274,Single Family - Detached,1301,27,0.02075,2020,91906
101,69,Multifamily,69,0,0.0,2020,91906
102,45,Mobile Home,45,0,0.0,2020,91906
103,1388,Total Units,1415,27,0.01908,2020,91906
104,1302,Single Family - Detached,1325,23,0.01736,2025,91906
105,69,Multifamily,69,0,0.0,2025,91906
106,45,Mobile Home,45,0,0.0,2025,91906
107,1416,Total Units,1439,23,0.01598,2025,91906
108,1335,Single Family - Detached,1361,26,0.0191,2030,91906
109,69,Multifamily,69,0,0.0,2030,91906
110,45,Mobile Home,45,0,0.0,2030,91906
111,1449,Total Units,1475,26,0.01763,2030,91906
112,1369,Single Family - Detached,1391,22,0.01582,2035,91906
113,69,Multifamily,69,0,0.0,2035,91906
114,45,Mobile Home,45,0,0.0,2035,91906
115,1483,Total Units,1505,22,0.01462,2035,91906
116,1382,Single Family - Detached,1411,29,0.02055,2040,91906
117,69,Multifamily,69,0,0.0,2040,91906
118,45,Mobile Home,45,0,0.0,2040,91906
119,1496,Total Units,1525,29,0.01902,2040,91906
120,1397,Single Family - Detached,1431,34,0.02376,2045,91906
121,69,Multifamily,69,0,0.0,2045,91906
122,45,Mobile Home,45,0,0.0,2045,91906
123,1511,Total Units,1545,34,0.02201,2045,91906
124,1574,Single Family - Detached,1611,37,0.02297,2050,91906
125,69,Multifamily,69,0,0.0,2050,91906
126,44,Mobile Home,45,1,0.02222,2050,91906
127,1687,Total Units,1725,38,0.02203,2050,91906
128,14580,Single Family - Detached,15023,443,0.02949,2012,91910
129,10636,Multifamily,11145,509,0.04567,2012,91910
130,1220,Mobile Home,1371,151,0.11014,2012,91910
131,26436,Total Units,27539,1103,0.04005,2012,91910
132,14489,Single Family - Detached,14968,479,0.032,2020,91910
133,10697,Multifamily,11185,488,0.04363,2020,91910
134,1004,Mobile Home,1123,119,0.10597,2020,91910
135,26190,Total Units,27276,1086,0.03982,2020,91910
136,14460,Single Family - Detached,14905,445,0.02986,2025,91910
137,11075,Multifamily,11520,445,0.03863,2025,91910
138,978,Mobile Home,1092,114,0.1044,2025,91910
139,26513,Total Units,27517,1004,0.03649,2025,91910
140,14305,Single Family - Detached,14772,467,0.03161,2030,91910
141,12089,Multifamily,12606,517,0.04101,2030,91910
142,972,Mobile Home,1092,120,0.10989,2030,91910
143,27366,Total Units,28470,1104,0.03878,2030,91910
144,14030,Single Family - Detached,14472,442,0.03054,2035,91910
145,14541,Multifamily,15117,576,0.0381,2035,91910
146,797,Mobile Home,881,84,0.09535,2035,91910
147,29368,Total Units,30470,1102,0.03617,2035,91910
148,14098,Single Family - Detached,14551,453,0.03113,2040,91910
149,15791,Multifamily,16477,686,0.04163,2040,91910
150,644,Mobile Home,700,56,0.08,2040,91910
151,30533,Total Units,31728,1195,0.03766,2040,91910
152,14033,Single Family - Detached,14527,494,0.03401,2045,91910
153,16458,Multifamily,17218,760,0.04414,2045,91910
154,321,Mobile Home,340,19,0.05588,2045,91910
155,30812,Total Units,32085,1273,0.03968,2045,91910
156,14014,Single Family - Detached,14519,505,0.03478,2050,91910
157,17126,Multifamily,17942,816,0.04548,2050,91910
158,273,Mobile Home,293,20,0.06826,2050,91910
159,31413,Total Units,32754,1341,0.04094,2050,91910
160,13954,Single Family - Detached,14211,257,0.01808,2012,91911
161,8758,Multifamily,8944,186,0.0208,2012,91911
162,2161,Mobile Home,2197,36,0.01639,2012,91911
163,24873,Total Units,25352,479,0.01889,2012,91911
164,13914,Single Family - Detached,14204,290,0.02042,2020,91911
165,8853,Multifamily,9047,194,0.02144,2020,91911
166,2038,Mobile Home,2066,28,0.01355,2020,91911
167,24805,Total Units,25317,512,0.02022,2020,91911
168,13940,Single Family - Detached,14196,256,0.01803,2025,91911
169,9061,Multifamily,9230,169,0.01831,2025,91911
170,2036,Mobile Home,2066,30,0.01452,2025,91911
171,25037,Total Units,25492,455,0.01785,2025,91911
172,13928,Single Family - Detached,14192,264,0.0186,2030,91911
173,9304,Multifamily,9485,181,0.01908,2030,91911
174,2024,Mobile Home,2066,42,0.02033,2030,91911
175,25256,Total Units,25743,487,0.01892,2030,91911
176,13881,Single Family - Detached,14128,247,0.01748,2035,91911
177,9476,Multifamily,9647,171,0.01773,2035,91911
178,2026,Mobile Home,2066,40,0.01936,2035,91911
179,25383,Total Units,25841,458,0.01772,2035,91911
180,13816,Single Family - Detached,14088,272,0.01931,2040,91911
181,10625,Multifamily,10851,226,0.02083,2040,91911
182,2017,Mobile Home,2050,33,0.0161,2040,91911
183,26458,Total Units,26989,531,0.01967,2040,91911
184,13786,Single Family - Detached,14093,307,0.02178,2045,91911
185,11168,Multifamily,11418,250,0.0219,2045,91911
186,1966,Mobile Home,2008,42,0.02092,2045,91911
187,26920,Total Units,27519,599,0.02177,2045,91911
188,13654,Single Family - Detached,13962,308,0.02206,2050,91911
189,12034,Multifamily,12318,284,0.02306,2050,91911
190,1901,Mobile Home,1981,80,0.04038,2050,91911
191,27589,Total Units,28261,672,0.02378,2050,91911
192,8334,Single Family - Detached,8492,158,0.01861,2012,91913
193,4118,Multifamily,4290,172,0.04009,2012,91913
194,197,Mobile Home,197,0,0.0,2012,91913
195,12649,Total Units,12979,330,0.02543,2012,91913
196,9668,Single Family - Detached,9887,219,0.02215,2020,91913
197,7771,Multifamily,8111,340,0.04192,2020,91913
198,197,Mobile Home,197,0,0.0,2020,91913
199,17636,Total Units,18195,559,0.03072,2020,91913
200,12072,Single Family - Detached,12297,225,0.0183,2025,91913
201,10177,Multifamily,10553,376,0.03563,2025,91913
202,197,Mobile Home,197,0,0.0,2025,91913
203,22446,Total Units,23047,601,0.02608,2025,91913
204,12069,Single Family - Detached,12297,228,0.01854,2030,91913
205,10177,Multifamily,10553,376,0.03563,2030,91913
206,196,Mobile Home,197,1,0.00508,2030,91913
207,22442,Total Units,23047,605,0.02625,2030,91913
208,12078,Single Family - Detached,12297,219,0.01781,2035,91913
209,10190,Multifamily,10553,363,0.0344,2035,91913
210,196,Mobile Home,197,1,0.00508,2035,91913
211,22464,Total Units,23047,583,0.0253,2035,91913
212,12002,Single Family - Detached,12248,246,0.02008,2040,91913
213,11694,Multifamily,12130,436,0.03594,2040,91913
214,196,Mobile Home,197,1,0.00508,2040,91913
215,23892,Total Units,24575,683,0.02779,2040,91913
216,11987,Single Family - Detached,12261,274,0.02235,2045,91913
217,12395,Multifamily,12852,457,0.03556,2045,91913
218,195,Mobile Home,197,2,0.01015,2045,91913
219,24577,Total Units,25310,733,0.02896,2045,91913
220,11980,Single Family - Detached,12263,283,0.02308,2050,91913
221,12398,Multifamily,12873,475,0.0369,2050,91913
222,191,Mobile Home,197,6,0.03046,2050,91913
223,24569,Total Units,25333,764,0.03016,2050,91913
224,3600,Single Family - Detached,3643,43,0.0118,2012,91914
225,1007,Multifamily,1065,58,0.05446,2012,91914
226,0,Mobile Home,0,0,,2012,91914
227,4607,Total Units,4708,101,0.02145,2012,91914
228,4190,Single Family - Detached,4251,61,0.01435,2020,91914
229,1012,Multifamily,1065,53,0.04977,2020,91914
230,0,Mobile Home,0,0,,2020,91914
231,5202,Total Units,5316,114,0.02144,2020,91914
232,4419,Single Family - Detached,4482,63,0.01406,2025,91914
233,1013,Multifamily,1065,52,0.04883,2025,91914
234,0,Mobile Home,0,0,,2025,91914
235,5432,Total Units,5547,115,0.02073,2025,91914
236,4700,Single Family - Detached,4767,67,0.01405,2030,91914
237,1013,Multifamily,1065,52,0.04883,2030,91914
238,0,Mobile Home,0,0,,2030,91914
239,5713,Total Units,5832,119,0.0204,2030,91914
240,4776,Single Family - Detached,4835,59,0.0122,2035,91914
241,1014,Multifamily,1065,51,0.04789,2035,91914
242,0,Mobile Home,0,0,,2035,91914
243,5790,Total Units,5900,110,0.01864,2035,91914
244,4890,Single Family - Detached,4964,74,0.01491,2040,91914
245,1012,Multifamily,1065,53,0.04977,2040,91914
246,0,Mobile Home,0,0,,2040,91914
247,5902,Total Units,6029,127,0.02106,2040,91914
248,4966,Single Family - Detached,5049,83,0.01644,2045,91914
249,1012,Multifamily,1065,53,0.04977,2045,91914
250,0,Mobile Home,0,0,,2045,91914
251,5978,Total Units,6114,136,0.02224,2045,91914
252,5001,Single Family - Detached,5086,85,0.01671,2050,91914
253,1012,Multifamily,1065,53,0.04977,2050,91914
254,0,Mobile Home,0,0,,2050,91914
255,6013,Total Units,6151,138,0.02244,2050,91914
256,5727,Single Family - Detached,5875,148,0.02519,2012,91915
257,1696,Multifamily,1718,22,0.01281,2012,91915
258,0,Mobile Home,0,0,,2012,91915
259,7423,Total Units,7593,170,0.02239,2012,91915
260,5838,Single Family - Detached,6006,168,0.02797,2020,91915
261,6030,Multifamily,6196,166,0.02679,2020,91915
262,0,Mobile Home,0,0,,2020,91915
263,11868,Total Units,12202,334,0.02737,2020,91915
264,6570,Single Family - Detached,6734,164,0.02435,2025,91915
265,8539,Multifamily,8766,227,0.0259,2025,91915
266,0,Mobile Home,0,0,,2025,91915
267,15109,Total Units,15500,391,0.02523,2025,91915
268,6568,Single Family - Detached,6734,166,0.02465,2030,91915
269,8538,Multifamily,8766,228,0.02601,2030,91915
270,0,Mobile Home,0,0,,2030,91915
271,15106,Total Units,15500,394,0.02542,2030,91915
272,6578,Single Family - Detached,6734,156,0.02317,2035,91915
273,8544,Multifamily,8766,222,0.02533,2035,91915
274,0,Mobile Home,0,0,,2035,91915
275,15122,Total Units,15500,378,0.02439,2035,91915
276,6559,Single Family - Detached,6734,175,0.02599,2040,91915
277,8504,Multifamily,8766,262,0.02989,2040,91915
278,0,Mobile Home,0,0,,2040,91915
279,15063,Total Units,15500,437,0.02819,2040,91915
280,6546,Single Family - Detached,6734,188,0.02792,2045,91915
281,8509,Multifamily,8821,312,0.03537,2045,91915
282,0,Mobile Home,0,0,,2045,91915
283,15055,Total Units,15555,500,0.03214,2045,91915
284,6542,Single Family - Detached,6734,192,0.02851,2050,91915
285,8526,Multifamily,8847,321,0.03628,2050,91915
286,0,Mobile Home,0,0,,2050,91915
287,15068,Total Units,15581,513,0.03292,2050,91915
288,678,Single Family - Detached,676,-2,-0.00296,2012,91916
289,0,Multifamily,2,2,1.0,2012,91916
290,101,Mobile Home,101,0,0.0,2012,91916
291,779,Total Units,779,0,0.0,2012,91916
292,680,Single Family - Detached,710,30,0.04225,2020,91916
293,1,Multifamily,2,1,0.5,2020,91916
294,101,Mobile Home,101,0,0.0,2020,91916
295,782,Total Units,813,31,0.03813,2020,91916
296,701,Single Family - Detached,717,16,0.02232,2025,91916
297,1,Multifamily,2,1,0.5,2025,91916
298,101,Mobile Home,101,0,0.0,2025,91916
299,803,Total Units,820,17,0.02073,2025,91916
300,701,Single Family - Detached,724,23,0.03177,2030,91916
301,1,Multifamily,2,1,0.5,2030,91916
302,101,Mobile Home,101,0,0.0,2030,91916
303,803,Total Units,827,24,0.02902,2030,91916
304,732,Single Family - Detached,755,23,0.03046,2035,91916
305,2,Multifamily,2,0,0.0,2035,91916
306,101,Mobile Home,101,0,0.0,2035,91916
307,835,Total Units,858,23,0.02681,2035,91916
308,731,Single Family - Detached,755,24,0.03179,2040,91916
309,1,Multifamily,2,1,0.5,2040,91916
310,101,Mobile Home,101,0,0.0,2040,91916
311,833,Total Units,858,25,0.02914,2040,91916
312,730,Single Family - Detached,758,28,0.03694,2045,91916
313,1,Multifamily,2,1,0.5,2045,91916
314,101,Mobile Home,101,0,0.0,2045,91916
315,832,Total Units,861,29,0.03368,2045,91916
316,733,Single Family - Detached,761,28,0.03679,2050,91916
317,0,Multifamily,2,2,1.0,2050,91916
318,99,Mobile Home,101,2,0.0198,2050,91916
319,832,Total Units,864,32,0.03704,2050,91916
320,226,Single Family - Detached,225,-1,-0.00444,2012,91917
321,2,Multifamily,3,1,0.33333,2012,91917
322,54,Mobile Home,54,0,0.0,2012,91917
323,282,Total Units,282,0,0.0,2012,91917
324,270,Single Family - Detached,269,-1,-0.00372,2020,91917
325,2,Multifamily,3,1,0.33333,2020,91917
326,54,Mobile Home,54,0,0.0,2020,91917
327,326,Total Units,326,0,0.0,2020,91917
328,271,Single Family - Detached,269,-2,-0.00743,2025,91917
329,2,Multifamily,3,1,0.33333,2025,91917
330,54,Mobile Home,54,0,0.0,2025,91917
331,327,Total Units,326,-1,-0.00307,2025,91917
332,283,Single Family - Detached,281,-2,-0.00712,2030,91917
333,2,Multifamily,3,1,0.33333,2030,91917
334,53,Mobile Home,54,1,0.01852,2030,91917
335,338,Total Units,338,0,0.0,2030,91917
336,280,Single Family - Detached,280,0,0.0,2035,91917
337,2,Multifamily,3,1,0.33333,2035,91917
338,53,Mobile Home,54,1,0.01852,2035,91917
339,335,Total Units,337,2,0.00593,2035,91917
340,279,Single Family - Detached,280,1,0.00357,2040,91917
341,2,Multifamily,3,1,0.33333,2040,91917
342,53,Mobile Home,54,1,0.01852,2040,91917
343,334,Total Units,337,3,0.0089,2040,91917
344,278,Single Family - Detached,280,2,0.00714,2045,91917
345,2,Multifamily,3,1,0.33333,2045,91917
346,52,Mobile Home,54,2,0.03704,2045,91917
347,332,Total Units,337,5,0.01484,2045,91917
348,278,Single Family - Detached,280,2,0.00714,2050,91917
349,2,Multifamily,3,1,0.33333,2050,91917
350,49,Mobile Home,54,5,0.09259,2050,91917
351,329,Total Units,337,8,0.02374,2050,91917
352,72,Single Family - Detached,70,-2,-0.02857,2012,91931
353,0,Multifamily,2,2,1.0,2012,91931
354,100,Mobile Home,100,0,0.0,2012,91931
355,172,Total Units,172,0,0.0,2012,91931
356,73,Single Family - Detached,77,4,0.05195,2020,91931
357,1,Multifamily,2,1,0.5,2020,91931
358,100,Mobile Home,100,0,0.0,2020,91931
359,174,Total Units,179,5,0.02793,2020,91931
360,79,Single Family - Detached,77,-2,-0.02597,2025,91931
361,1,Multifamily,2,1,0.5,2025,91931
362,100,Mobile Home,100,0,0.0,2025,91931
363,180,Total Units,179,-1,-0.00559,2025,91931
364,70,Single Family - Detached,77,7,0.09091,2030,91931
365,1,Multifamily,2,1,0.5,2030,91931
366,99,Mobile Home,100,1,0.01,2030,91931
367,170,Total Units,179,9,0.05028,2030,91931
368,70,Single Family - Detached,77,7,0.09091,2035,91931
369,1,Multifamily,2,1,0.5,2035,91931
370,99,Mobile Home,100,1,0.01,2035,91931
371,170,Total Units,179,9,0.05028,2035,91931
372,69,Single Family - Detached,77,8,0.1039,2040,91931
373,1,Multifamily,2,1,0.5,2040,91931
374,99,Mobile Home,100,1,0.01,2040,91931
375,169,Total Units,179,10,0.05587,2040,91931
376,67,Single Family - Detached,77,10,0.12987,2045,91931
377,1,Multifamily,2,1,0.5,2045,91931
378,98,Mobile Home,100,2,0.02,2045,91931
379,166,Total Units,179,13,0.07263,2045,91931
380,66,Single Family - Detached,77,11,0.14286,2050,91931
381,1,Multifamily,2,1,0.5,2050,91931
382,96,Mobile Home,100,4,0.04,2050,91931
383,163,Total Units,179,16,0.08939,2050,91931
384,5239,Single Family - Detached,5555,316,0.05689,2012,91932
385,3690,Multifamily,4000,310,0.0775,2012,91932
386,274,Mobile Home,309,35,0.11327,2012,91932
387,9203,Total Units,9864,661,0.06701,2012,91932
388,5115,Single Family - Detached,5454,339,0.06216,2020,91932
389,3933,Multifamily,4239,306,0.07219,2020,91932
390,276,Mobile Home,309,33,0.1068,2020,91932
391,9324,Total Units,10002,678,0.06779,2020,91932
392,5131,Single Family - Detached,5430,299,0.05506,2025,91932
393,4456,Multifamily,4768,312,0.06544,2025,91932
394,206,Mobile Home,234,28,0.11966,2025,91932
395,9793,Total Units,10432,639,0.06125,2025,91932
396,5123,Single Family - Detached,5429,306,0.05636,2030,91932
397,4802,Multifamily,5138,336,0.0654,2030,91932
398,185,Mobile Home,214,29,0.13551,2030,91932
399,10110,Total Units,10781,671,0.06224,2030,91932
400,5083,Single Family - Detached,5362,279,0.05203,2035,91932
401,5018,Multifamily,5351,333,0.06223,2035,91932
402,185,Mobile Home,214,29,0.13551,2035,91932
403,10286,Total Units,10927,641,0.05866,2035,91932
404,4937,Single Family - Detached,5229,292,0.05584,2040,91932
405,5613,Multifamily,6003,390,0.06497,2040,91932
406,185,Mobile Home,214,29,0.13551,2040,91932
407,10735,Total Units,11446,711,0.06212,2040,91932
408,4883,Single Family - Detached,5199,316,0.06078,2045,91932
409,5665,Multifamily,6079,414,0.0681,2045,91932
410,185,Mobile Home,214,29,0.13551,2045,91932
411,10733,Total Units,11492,759,0.06605,2045,91932
412,4873,Single Family - Detached,5192,319,0.06144,2050,91932
413,5702,Multifamily,6123,421,0.06876,2050,91932
414,181,Mobile Home,214,33,0.15421,2050,91932
415,10756,Total Units,11529,773,0.06705,2050,91932
416,261,Single Family - Detached,326,65,0.19939,2012,91934
417,76,Multifamily,77,1,0.01299,2012,91934
418,39,Mobile Home,40,1,0.025,2012,91934
419,376,Total Units,443,67,0.15124,2012,91934
420,275,Single Family - Detached,333,58,0.17417,2020,91934
421,77,Multifamily,77,0,0.0,2020,91934
422,40,Mobile Home,40,0,0.0,2020,91934
423,392,Total Units,450,58,0.12889,2020,91934
424,324,Single Family - Detached,375,51,0.136,2025,91934
425,77,Multifamily,77,0,0.0,2025,91934
426,39,Mobile Home,40,1,0.025,2025,91934
427,440,Total Units,492,52,0.10569,2025,91934
428,500,Single Family - Detached,577,77,0.13345,2030,91934
429,77,Multifamily,77,0,0.0,2030,91934
430,39,Mobile Home,40,1,0.025,2030,91934
431,616,Total Units,694,78,0.11239,2030,91934
432,527,Single Family - Detached,602,75,0.12458,2035,91934
433,77,Multifamily,77,0,0.0,2035,91934
434,40,Mobile Home,40,0,0.0,2035,91934
435,644,Total Units,719,75,0.10431,2035,91934
436,566,Single Family - Detached,655,89,0.13588,2040,91934
437,77,Multifamily,77,0,0.0,2040,91934
438,40,Mobile Home,40,0,0.0,2040,91934
439,683,Total Units,772,89,0.11528,2040,91934
440,608,Single Family - Detached,713,105,0.14727,2045,91934
441,77,Multifamily,77,0,0.0,2045,91934
442,40,Mobile Home,40,0,0.0,2045,91934
443,725,Total Units,830,105,0.12651,2045,91934
444,652,Single Family - Detached,766,114,0.14883,2050,91934
445,76,Multifamily,77,1,0.01299,2050,91934
446,39,Mobile Home,40,1,0.025,2050,91934
447,767,Total Units,883,116,0.13137,2050,91934
448,2775,Single Family - Detached,2849,74,0.02597,2012,91935
449,123,Multifamily,121,-2,-0.01653,2012,91935
450,42,Mobile Home,42,0,0.0,2012,91935
451,2940,Total Units,3012,72,0.0239,2012,91935
452,3081,Single Family - Detached,3168,87,0.02746,2020,91935
453,123,Multifamily,121,-2,-0.01653,2020,91935
454,42,Mobile Home,42,0,0.0,2020,91935
455,3246,Total Units,3331,85,0.02552,2020,91935
456,3123,Single Family - Detached,3193,70,0.02192,2025,91935
457,123,Multifamily,121,-2,-0.01653,2025,91935
458,41,Mobile Home,42,1,0.02381,2025,91935
459,3287,Total Units,3356,69,0.02056,2025,91935
460,3198,Single Family - Detached,3275,77,0.02351,2030,91935
461,122,Multifamily,121,-1,-0.00826,2030,91935
462,42,Mobile Home,42,0,0.0,2030,91935
463,3362,Total Units,3438,76,0.02211,2030,91935
464,3350,Single Family - Detached,3422,72,0.02104,2035,91935
465,123,Multifamily,121,-2,-0.01653,2035,91935
466,42,Mobile Home,42,0,0.0,2035,91935
467,3515,Total Units,3585,70,0.01953,2035,91935
468,3536,Single Family - Detached,3617,81,0.02239,2040,91935
469,123,Multifamily,121,-2,-0.01653,2040,91935
470,37,Mobile Home,37,0,0.0,2040,91935
471,3696,Total Units,3775,79,0.02093,2040,91935
472,3806,Single Family - Detached,3898,92,0.0236,2045,91935
473,122,Multifamily,121,-1,-0.00826,2045,91935
474,31,Mobile Home,32,1,0.03125,2045,91935
475,3959,Total Units,4051,92,0.02271,2045,91935
476,3807,Single Family - Detached,3902,95,0.02435,2050,91935
477,121,Multifamily,121,0,0.0,2050,91935
478,25,Mobile Home,26,1,0.03846,2050,91935
479,3953,Total Units,4049,96,0.02371,2050,91935
480,9526,Single Family - Detached,9758,232,0.02378,2012,91941
481,3502,Multifamily,3558,56,0.01574,2012,91941
482,0,Mobile Home,0,0,,2012,91941
483,13028,Total Units,13316,288,0.02163,2012,91941
484,9642,Single Family - Detached,9902,260,0.02626,2020,91941
485,3399,Multifamily,3458,59,0.01706,2020,91941
486,0,Mobile Home,0,0,,2020,91941
487,13041,Total Units,13360,319,0.02388,2020,91941
488,9829,Single Family - Detached,10015,186,0.01857,2025,91941
489,3422,Multifamily,3464,42,0.01212,2025,91941
490,0,Mobile Home,0,0,,2025,91941
491,13251,Total Units,13479,228,0.01692,2025,91941
492,9821,Single Family - Detached,10022,201,0.02006,2030,91941
493,3614,Multifamily,3666,52,0.01418,2030,91941
494,0,Mobile Home,0,0,,2030,91941
495,13435,Total Units,13688,253,0.01848,2030,91941
496,9881,Single Family - Detached,10059,178,0.0177,2035,91941
497,3832,Multifamily,3912,80,0.02045,2035,91941
498,0,Mobile Home,0,0,,2035,91941
499,13713,Total Units,13971,258,0.01847,2035,91941
500,9869,Single Family - Detached,10077,208,0.02064,2040,91941
501,4031,Multifamily,4132,101,0.02444,2040,91941
502,0,Mobile Home,0,0,,2040,91941
503,13900,Total Units,14209,309,0.02175,2040,91941
504,9899,Single Family - Detached,10148,249,0.02454,2045,91941
505,4365,Multifamily,4478,113,0.02523,2045,91941
506,0,Mobile Home,0,0,,2045,91941
507,14264,Total Units,14626,362,0.02475,2045,91941
508,9891,Single Family - Detached,10150,259,0.02552,2050,91941
509,4939,Multifamily,5074,135,0.02661,2050,91941
510,0,Mobile Home,0,0,,2050,91941
511,14830,Total Units,15224,394,0.02588,2050,91941
512,8137,Single Family - Detached,8423,286,0.03395,2012,91942
513,8360,Multifamily,8765,405,0.04621,2012,91942
514,260,Mobile Home,332,72,0.21687,2012,91942
515,16757,Total Units,17520,763,0.04355,2012,91942
516,8150,Single Family - Detached,8465,315,0.03721,2020,91942
517,8927,Multifamily,9363,436,0.04657,2020,91942
518,122,Mobile Home,157,35,0.22293,2020,91942
519,17199,Total Units,17985,786,0.0437,2020,91942
520,8225,Single Family - Detached,8485,260,0.03064,2025,91942
521,9147,Multifamily,9538,391,0.04099,2025,91942
522,96,Mobile Home,123,27,0.21951,2025,91942
523,17468,Total Units,18146,678,0.03736,2025,91942
524,8256,Single Family - Detached,8514,258,0.0303,2030,91942
525,10662,Multifamily,11107,445,0.04006,2030,91942
526,0,Mobile Home,0,0,,2030,91942
527,18918,Total Units,19621,703,0.03583,2030,91942
528,8234,Single Family - Detached,8489,255,0.03004,2035,91942
529,11956,Multifamily,12385,429,0.03464,2035,91942
530,0,Mobile Home,0,0,,2035,91942
531,20190,Total Units,20874,684,0.03277,2035,91942
532,8187,Single Family - Detached,8454,267,0.03158,2040,91942
533,12647,Multifamily,13125,478,0.03642,2040,91942
534,0,Mobile Home,0,0,,2040,91942
535,20834,Total Units,21579,745,0.03452,2040,91942
536,8181,Single Family - Detached,8455,274,0.03241,2045,91942
537,12825,Multifamily,13333,508,0.0381,2045,91942
538,0,Mobile Home,0,0,,2045,91942
539,21006,Total Units,21788,782,0.03589,2045,91942
540,8171,Single Family - Detached,8445,274,0.03245,2050,91942
541,14040,Multifamily,14614,574,0.03928,2050,91942
542,0,Mobile Home,0,0,,2050,91942
543,22211,Total Units,23059,848,0.03678,2050,91942
544,6780,Single Family - Detached,6949,169,0.02432,2012,91945
545,1704,Multifamily,1817,113,0.06219,2012,91945
546,28,Mobile Home,47,19,0.40426,2012,91945
547,8512,Total Units,8813,301,0.03415,2012,91945
548,6786,Single Family - Detached,6973,187,0.02682,2020,91945
549,1967,Multifamily,2098,131,0.06244,2020,91945
550,30,Mobile Home,47,17,0.3617,2020,91945
551,8783,Total Units,9118,335,0.03674,2020,91945
552,6825,Single Family - Detached,6980,155,0.02221,2025,91945
553,2113,Multifamily,2235,122,0.05459,2025,91945
554,28,Mobile Home,47,19,0.40426,2025,91945
555,8966,Total Units,9262,296,0.03196,2025,91945
556,6838,Single Family - Detached,6995,157,0.02244,2030,91945
557,2383,Multifamily,2523,140,0.05549,2030,91945
558,29,Mobile Home,47,18,0.38298,2030,91945
559,9250,Total Units,9565,315,0.03293,2030,91945
560,6868,Single Family - Detached,7012,144,0.02054,2035,91945
561,2458,Multifamily,2595,137,0.05279,2035,91945
562,31,Mobile Home,47,16,0.34043,2035,91945
563,9357,Total Units,9654,297,0.03076,2035,91945
564,6844,Single Family - Detached,6999,155,0.02215,2040,91945
565,2838,Multifamily,3006,168,0.05589,2040,91945
566,8,Mobile Home,11,3,0.27273,2040,91945
567,9690,Total Units,10016,326,0.03255,2040,91945
568,6826,Single Family - Detached,6991,165,0.0236,2045,91945
569,2972,Multifamily,3159,187,0.0592,2045,91945
570,7,Mobile Home,11,4,0.36364,2045,91945
571,9805,Total Units,10161,356,0.03504,2045,91945
572,6825,Single Family - Detached,6992,167,0.02388,2050,91945
573,3308,Multifamily,3523,215,0.06103,2050,91945
574,7,Mobile Home,11,4,0.36364,2050,91945
575,10140,Total Units,10526,386,0.03667,2050,91945
576,142,Single Family - Detached,252,110,0.43651,2012,91948
577,0,Multifamily,1,1,1.0,2012,91948
578,0,Mobile Home,0,0,,2012,91948
579,142,Total Units,253,111,0.43874,2012,91948
580,141,Single Family - Detached,252,111,0.44048,2020,91948
581,0,Multifamily,1,1,1.0,2020,91948
582,0,Mobile Home,0,0,,2020,91948
583,141,Total Units,253,112,0.44269,2020,91948
584,143,Single Family - Detached,252,109,0.43254,2025,91948
585,0,Multifamily,1,1,1.0,2025,91948
586,0,Mobile Home,0,0,,2025,91948
587,143,Total Units,253,110,0.43478,2025,91948
588,141,Single Family - Detached,256,115,0.44922,2030,91948
589,0,Multifamily,1,1,1.0,2030,91948
590,0,Mobile Home,0,0,,2030,91948
591,141,Total Units,257,116,0.45136,2030,91948
592,141,Single Family - Detached,256,115,0.44922,2035,91948
593,0,Multifamily,1,1,1.0,2035,91948
594,0,Mobile Home,0,0,,2035,91948
595,141,Total Units,257,116,0.45136,2035,91948
596,141,Single Family - Detached,256,115,0.44922,2040,91948
597,0,Multifamily,1,1,1.0,2040,91948
598,0,Mobile Home,0,0,,2040,91948
599,141,Total Units,257,116,0.45136,2040,91948
600,138,Single Family - Detached,256,118,0.46094,2045,91948
601,0,Multifamily,1,1,1.0,2045,91948
602,0,Mobile Home,0,0,,2045,91948
603,138,Total Units,257,119,0.46304,2045,91948
604,137,Single Family - Detached,256,119,0.46484,2050,91948
605,0,Multifamily,1,1,1.0,2050,91948
606,0,Mobile Home,0,0,,2050,91948
607,137,Total Units,257,120,0.46693,2050,91948
608,8979,Single Family - Detached,9438,459,0.04863,2012,91950
609,6727,Multifamily,7281,554,0.07609,2012,91950
610,357,Mobile Home,388,31,0.0799,2012,91950
611,16063,Total Units,17107,1044,0.06103,2012,91950
612,8951,Single Family - Detached,9429,478,0.05069,2020,91950
613,7491,Multifamily,8070,579,0.07175,2020,91950
614,329,Mobile Home,357,28,0.07843,2020,91950
615,16771,Total Units,17856,1085,0.06076,2020,91950
616,8999,Single Family - Detached,9383,384,0.04093,2025,91950
617,8227,Multifamily,8781,554,0.06309,2025,91950
618,275,Mobile Home,301,26,0.08638,2025,91950
619,17501,Total Units,18465,964,0.05221,2025,91950
620,8867,Single Family - Detached,9254,387,0.04182,2030,91950
621,9800,Multifamily,10401,601,0.05778,2030,91950
622,273,Mobile Home,301,28,0.09302,2030,91950
623,18940,Total Units,19956,1016,0.05091,2030,91950
624,8828,Single Family - Detached,9182,354,0.03855,2035,91950
625,11157,Multifamily,11796,639,0.05417,2035,91950
626,273,Mobile Home,301,28,0.09302,2035,91950
627,20258,Total Units,21279,1021,0.04798,2035,91950
628,8596,Single Family - Detached,8973,377,0.04201,2040,91950
629,12864,Multifamily,13638,774,0.05675,2040,91950
630,273,Mobile Home,301,28,0.09302,2040,91950
631,21733,Total Units,22912,1179,0.05146,2040,91950
632,8308,Single Family - Detached,8711,403,0.04626,2045,91950
633,13830,Multifamily,14702,872,0.05931,2045,91950
634,272,Mobile Home,301,29,0.09635,2045,91950
635,22410,Total Units,23714,1304,0.05499,2045,91950
636,8253,Single Family - Detached,8666,413,0.04766,2050,91950
637,15304,Multifamily,16275,971,0.05966,2050,91950
638,266,Mobile Home,301,35,0.11628,2050,91950
639,23823,Total Units,25242,1419,0.05622,2050,91950
640,694,Single Family - Detached,731,37,0.05062,2012,91962
641,7,Multifamily,5,-2,-0.4,2012,91962
642,0,Mobile Home,0,0,,2012,91962
643,701,Total Units,736,35,0.04755,2012,91962
644,743,Single Family - Detached,792,49,0.06187,2020,91962
645,7,Multifamily,5,-2,-0.4,2020,91962
646,0,Mobile Home,0,0,,2020,91962
647,750,Total Units,797,47,0.05897,2020,91962
648,763,Single Family - Detached,798,35,0.04386,2025,91962
649,7,Multifamily,5,-2,-0.4,2025,91962
650,0,Mobile Home,0,0,,2025,91962
651,770,Total Units,803,33,0.0411,2025,91962
652,872,Single Family - Detached,901,29,0.03219,2030,91962
653,7,Multifamily,5,-2,-0.4,2030,91962
654,0,Mobile Home,0,0,,2030,91962
655,879,Total Units,906,27,0.0298,2030,91962
656,966,Single Family - Detached,995,29,0.02915,2035,91962
657,7,Multifamily,5,-2,-0.4,2035,91962
658,0,Mobile Home,0,0,,2035,91962
659,973,Total Units,1000,27,0.027,2035,91962
660,965,Single Family - Detached,995,30,0.03015,2040,91962
661,7,Multifamily,5,-2,-0.4,2040,91962
662,0,Mobile Home,0,0,,2040,91962
663,972,Total Units,1000,28,0.028,2040,91962
664,960,Single Family - Detached,996,36,0.03614,2045,91962
665,7,Multifamily,5,-2,-0.4,2045,91962
666,0,Mobile Home,0,0,,2045,91962
667,967,Total Units,1001,34,0.03397,2045,91962
668,959,Single Family - Detached,998,39,0.03908,2050,91962
669,7,Multifamily,5,-2,-0.4,2050,91962
670,0,Mobile Home,0,0,,2050,91962
671,966,Total Units,1003,37,0.03689,2050,91962
672,259,Single Family - Detached,258,-1,-0.00388,2012,91963
673,0,Multifamily,1,1,1.0,2012,91963
674,113,Mobile Home,113,0,0.0,2012,91963
675,372,Total Units,372,0,0.0,2012,91963
676,280,Single Family - Detached,279,-1,-0.00358,2020,91963
677,1,Multifamily,1,0,0.0,2020,91963
678,113,Mobile Home,113,0,0.0,2020,91963
679,394,Total Units,393,-1,-0.00254,2020,91963
680,313,Single Family - Detached,312,-1,-0.00321,2025,91963
681,1,Multifamily,1,0,0.0,2025,91963
682,113,Mobile Home,113,0,0.0,2025,91963
683,427,Total Units,426,-1,-0.00235,2025,91963
684,364,Single Family - Detached,364,0,0.0,2030,91963
685,1,Multifamily,1,0,0.0,2030,91963
686,113,Mobile Home,113,0,0.0,2030,91963
687,478,Total Units,478,0,0.0,2030,91963
688,368,Single Family - Detached,368,0,0.0,2035,91963
689,1,Multifamily,1,0,0.0,2035,91963
690,113,Mobile Home,113,0,0.0,2035,91963
691,482,Total Units,482,0,0.0,2035,91963
692,374,Single Family - Detached,374,0,0.0,2040,91963
693,1,Multifamily,1,0,0.0,2040,91963
694,113,Mobile Home,113,0,0.0,2040,91963
695,488,Total Units,488,0,0.0,2040,91963
696,381,Single Family - Detached,381,0,0.0,2045,91963
697,1,Multifamily,1,0,0.0,2045,91963
698,113,Mobile Home,113,0,0.0,2045,91963
699,495,Total Units,495,0,0.0,2045,91963
700,440,Single Family - Detached,440,0,0.0,2050,91963
701,1,Multifamily,1,0,0.0,2050,91963
702,112,Mobile Home,113,1,0.00885,2050,91963
703,553,Total Units,554,1,0.00181,2050,91963
704,13366,Single Family - Detached,14196,830,0.05847,2012,91977
705,4562,Multifamily,4515,-47,-0.01041,2012,91977
706,821,Mobile Home,893,72,0.08063,2012,91977
707,18749,Total Units,19604,855,0.04361,2012,91977
708,13796,Single Family - Detached,14753,957,0.06487,2020,91977
709,4289,Multifamily,4497,208,0.04625,2020,91977
710,824,Mobile Home,893,69,0.07727,2020,91977
711,18909,Total Units,20143,1234,0.06126,2020,91977
712,14876,Single Family - Detached,15659,783,0.05,2025,91977
713,4307,Multifamily,4497,190,0.04225,2025,91977
714,823,Mobile Home,893,70,0.07839,2025,91977
715,20006,Total Units,21049,1043,0.04955,2025,91977
716,14900,Single Family - Detached,15717,817,0.05198,2030,91977
717,4324,Multifamily,4514,190,0.04209,2030,91977
718,818,Mobile Home,893,75,0.08399,2030,91977
719,20042,Total Units,21124,1082,0.05122,2030,91977
720,14915,Single Family - Detached,15716,801,0.05097,2035,91977
721,4316,Multifamily,4505,189,0.04195,2035,91977
722,819,Mobile Home,893,74,0.08287,2035,91977
723,20050,Total Units,21114,1064,0.05039,2035,91977
724,15061,Single Family - Detached,16255,1194,0.07345,2040,91977
725,4246,Multifamily,4482,236,0.05266,2040,91977
726,821,Mobile Home,893,72,0.08063,2040,91977
727,20128,Total Units,21630,1502,0.06944,2040,91977
728,15326,Single Family - Detached,16689,1363,0.08167,2045,91977
729,4248,Multifamily,4491,243,0.05411,2045,91977
730,817,Mobile Home,893,76,0.08511,2045,91977
731,20391,Total Units,22073,1682,0.0762,2045,91977
732,15292,Single Family - Detached,16698,1406,0.0842,2050,91977
733,4112,Multifamily,4359,247,0.05666,2050,91977
734,801,Mobile Home,893,92,0.10302,2050,91977
735,20205,Total Units,21950,1745,0.0795,2050,91977
736,1419,Single Family - Detached,1734,315,0.18166,2012,91978
737,792,Multifamily,553,-239,-0.43219,2012,91978
738,566,Mobile Home,601,35,0.05824,2012,91978
739,2777,Total Units,2888,111,0.03843,2012,91978
740,1732,Single Family - Detached,2112,380,0.17992,2020,91978
741,703,Multifamily,553,-150,-0.27125,2020,91978
742,568,Mobile Home,601,33,0.05491,2020,91978
743,3003,Total Units,3266,263,0.08053,2020,91978
744,2103,Single Family - Detached,2500,397,0.1588,2025,91978
745,693,Multifamily,553,-140,-0.25316,2025,91978
746,567,Mobile Home,601,34,0.05657,2025,91978
747,3363,Total Units,3654,291,0.07964,2025,91978
748,2132,Single Family - Detached,2533,401,0.15831,2030,91978
749,692,Multifamily,553,-139,-0.25136,2030,91978
750,564,Mobile Home,601,37,0.06156,2030,91978
751,3388,Total Units,3687,299,0.0811,2030,91978
752,2133,Single Family - Detached,2533,400,0.15792,2035,91978
753,692,Multifamily,553,-139,-0.25136,2035,91978
754,565,Mobile Home,601,36,0.0599,2035,91978
755,3390,Total Units,3687,297,0.08055,2035,91978
756,2664,Single Family - Detached,2829,165,0.05832,2040,91978
757,755,Multifamily,583,-172,-0.29503,2040,91978
758,566,Mobile Home,601,35,0.05824,2040,91978
759,3985,Total Units,4013,28,0.00698,2040,91978
760,2801,Single Family - Detached,2978,177,0.05944,2045,91978
761,755,Multifamily,583,-172,-0.29503,2045,91978
762,563,Mobile Home,601,38,0.06323,2045,91978
763,4119,Total Units,4162,43,0.01033,2045,91978
764,2799,Single Family - Detached,2979,180,0.06042,2050,91978
765,755,Multifamily,583,-172,-0.29503,2050,91978
766,552,Mobile Home,601,49,0.08153,2050,91978
767,4106,Total Units,4163,57,0.01369,2050,91978
768,53,Single Family - Detached,50,-3,-0.06,2012,91980
769,5,Multifamily,8,3,0.375,2012,91980
770,0,Mobile Home,0,0,,2012,91980
771,58,Total Units,58,0,0.0,2012,91980
772,48,Single Family - Detached,49,1,0.02041,2020,91980
773,8,Multifamily,8,0,0.0,2020,91980
774,0,Mobile Home,0,0,,2020,91980
775,56,Total Units,57,1,0.01754,2020,91980
776,48,Single Family - Detached,49,1,0.02041,2025,91980
777,8,Multifamily,8,0,0.0,2025,91980
778,0,Mobile Home,0,0,,2025,91980
779,56,Total Units,57,1,0.01754,2025,91980
780,86,Single Family - Detached,86,0,0.0,2030,91980
781,8,Multifamily,8,0,0.0,2030,91980
782,0,Mobile Home,0,0,,2030,91980
783,94,Total Units,94,0,0.0,2030,91980
784,95,Single Family - Detached,95,0,0.0,2035,91980
785,8,Multifamily,8,0,0.0,2035,91980
786,0,Mobile Home,0,0,,2035,91980
787,103,Total Units,103,0,0.0,2035,91980
788,100,Single Family - Detached,101,1,0.0099,2040,91980
789,8,Multifamily,8,0,0.0,2040,91980
790,0,Mobile Home,0,0,,2040,91980
791,108,Total Units,109,1,0.00917,2040,91980
792,109,Single Family - Detached,110,1,0.00909,2045,91980
793,8,Multifamily,8,0,0.0,2045,91980
794,0,Mobile Home,0,0,,2045,91980
795,117,Total Units,118,1,0.00847,2045,91980
796,168,Single Family - Detached,169,1,0.00592,2050,91980
797,8,Multifamily,8,0,0.0,2050,91980
798,0,Mobile Home,0,0,,2050,91980
799,176,Total Units,177,1,0.00565,2050,91980
800,1296,Single Family - Detached,1389,93,0.06695,2012,92003
801,317,Multifamily,319,2,0.00627,2012,92003
802,0,Mobile Home,0,0,,2012,92003
803,1613,Total Units,1708,95,0.05562,2012,92003
804,1534,Single Family - Detached,1649,115,0.06974,2020,92003
805,319,Multifamily,319,0,0.0,2020,92003
806,0,Mobile Home,0,0,,2020,92003
807,1853,Total Units,1968,115,0.05843,2020,92003
808,1702,Single Family - Detached,1802,100,0.05549,2025,92003
809,319,Multifamily,319,0,0.0,2025,92003
810,0,Mobile Home,0,0,,2025,92003
811,2021,Total Units,2121,100,0.04715,2025,92003
812,1802,Single Family - Detached,1905,103,0.05407,2030,92003
813,319,Multifamily,319,0,0.0,2030,92003
814,0,Mobile Home,0,0,,2030,92003
815,2121,Total Units,2224,103,0.04631,2030,92003
816,2089,Single Family - Detached,2182,93,0.04262,2035,92003
817,319,Multifamily,319,0,0.0,2035,92003
818,0,Mobile Home,0,0,,2035,92003
819,2408,Total Units,2501,93,0.03719,2035,92003
820,2122,Single Family - Detached,2225,103,0.04629,2040,92003
821,319,Multifamily,319,0,0.0,2040,92003
822,0,Mobile Home,0,0,,2040,92003
823,2441,Total Units,2544,103,0.04049,2040,92003
824,2154,Single Family - Detached,2265,111,0.04901,2045,92003
825,319,Multifamily,319,0,0.0,2045,92003
826,0,Mobile Home,0,0,,2045,92003
827,2473,Total Units,2584,111,0.04296,2045,92003
828,2154,Single Family - Detached,2269,115,0.05068,2050,92003
829,319,Multifamily,319,0,0.0,2050,92003
830,0,Mobile Home,0,0,,2050,92003
831,2473,Total Units,2588,115,0.04444,2050,92003
832,1341,Single Family - Detached,2163,822,0.38003,2012,92004
833,190,Multifamily,228,38,0.16667,2012,92004
834,512,Mobile Home,807,295,0.36555,2012,92004
835,2043,Total Units,3198,1155,0.36116,2012,92004
836,1370,Single Family - Detached,2277,907,0.39833,2020,92004
837,199,Multifamily,228,29,0.12719,2020,92004
838,515,Mobile Home,807,292,0.36183,2020,92004
839,2084,Total Units,3312,1228,0.37077,2020,92004
840,1576,Single Family - Detached,2342,766,0.32707,2025,92004
841,200,Multifamily,228,28,0.12281,2025,92004
842,514,Mobile Home,807,293,0.36307,2025,92004
843,2290,Total Units,3377,1087,0.32188,2025,92004
844,1623,Single Family - Detached,2442,819,0.33538,2030,92004
845,233,Multifamily,285,52,0.18246,2030,92004
846,511,Mobile Home,807,296,0.36679,2030,92004
847,2367,Total Units,3534,1167,0.33022,2030,92004
848,1784,Single Family - Detached,2608,824,0.31595,2035,92004
849,234,Multifamily,285,51,0.17895,2035,92004
850,512,Mobile Home,807,295,0.36555,2035,92004
851,2530,Total Units,3700,1170,0.31622,2035,92004
852,1812,Single Family - Detached,2704,892,0.32988,2040,92004
853,234,Multifamily,285,51,0.17895,2040,92004
854,513,Mobile Home,807,294,0.36431,2040,92004
855,2559,Total Units,3796,1237,0.32587,2040,92004
856,1800,Single Family - Detached,2801,1001,0.35737,2045,92004
857,234,Multifamily,285,51,0.17895,2045,92004
858,511,Mobile Home,807,296,0.36679,2045,92004
859,2545,Total Units,3893,1348,0.34626,2045,92004
860,2282,Single Family - Detached,3600,1318,0.36611,2050,92004
861,234,Multifamily,285,51,0.17895,2050,92004
862,501,Mobile Home,807,306,0.37918,2050,92004
863,3017,Total Units,4692,1675,0.35699,2050,92004
864,3892,Single Family - Detached,4137,245,0.05922,2012,92007
865,640,Multifamily,716,76,0.10615,2012,92007
866,0,Mobile Home,0,0,,2012,92007
867,4532,Total Units,4853,321,0.06614,2012,92007
868,3898,Single Family - Detached,4161,263,0.06321,2020,92007
869,644,Multifamily,717,73,0.10181,2020,92007
870,0,Mobile Home,0,0,,2020,92007
871,4542,Total Units,4878,336,0.06888,2020,92007
872,3924,Single Family - Detached,4173,249,0.05967,2025,92007
873,673,Multifamily,738,65,0.08808,2025,92007
874,0,Mobile Home,0,0,,2025,92007
875,4597,Total Units,4911,314,0.06394,2025,92007
876,3933,Single Family - Detached,4187,254,0.06066,2030,92007
877,698,Multifamily,767,69,0.08996,2030,92007
878,0,Mobile Home,0,0,,2030,92007
879,4631,Total Units,4954,323,0.0652,2030,92007
880,3953,Single Family - Detached,4190,237,0.05656,2035,92007
881,726,Multifamily,793,67,0.08449,2035,92007
882,0,Mobile Home,0,0,,2035,92007
883,4679,Total Units,4983,304,0.06101,2035,92007
884,3985,Single Family - Detached,4237,252,0.05948,2040,92007
885,726,Multifamily,797,71,0.08908,2040,92007
886,0,Mobile Home,0,0,,2040,92007
887,4711,Total Units,5034,323,0.06416,2040,92007
888,3983,Single Family - Detached,4255,272,0.06392,2045,92007
889,726,Multifamily,797,71,0.08908,2045,92007
890,0,Mobile Home,0,0,,2045,92007
891,4709,Total Units,5052,343,0.06789,2045,92007
892,4009,Single Family - Detached,4292,283,0.06594,2050,92007
893,726,Multifamily,797,71,0.08908,2050,92007
894,0,Mobile Home,0,0,,2050,92007
895,4735,Total Units,5089,354,0.06956,2050,92007
896,6167,Single Family - Detached,6530,363,0.05559,2012,92008
897,5341,Multifamily,5858,517,0.08826,2012,92008
898,124,Mobile Home,156,32,0.20513,2012,92008
899,11632,Total Units,12544,912,0.0727,2012,92008
900,6484,Single Family - Detached,6900,416,0.06029,2020,92008
901,5569,Multifamily,6127,558,0.09107,2020,92008
902,126,Mobile Home,157,31,0.19745,2020,92008
903,12179,Total Units,13184,1005,0.07623,2020,92008
904,6593,Single Family - Detached,6939,346,0.04986,2025,92008
905,6002,Multifamily,6543,541,0.08268,2025,92008
906,125,Mobile Home,157,32,0.20382,2025,92008
907,12720,Total Units,13639,919,0.06738,2025,92008
908,6679,Single Family - Detached,7037,358,0.05087,2030,92008
909,6327,Multifamily,6910,583,0.08437,2030,92008
910,124,Mobile Home,157,33,0.21019,2030,92008
911,13130,Total Units,14104,974,0.06906,2030,92008
912,6872,Single Family - Detached,7213,341,0.04728,2035,92008
913,6508,Multifamily,7080,572,0.08079,2035,92008
914,125,Mobile Home,157,32,0.20382,2035,92008
915,13505,Total Units,14450,945,0.0654,2035,92008
916,6863,Single Family - Detached,7213,350,0.04852,2040,92008
917,6812,Multifamily,7301,489,0.06698,2040,92008
918,125,Mobile Home,157,32,0.20382,2040,92008
919,13800,Total Units,14671,871,0.05937,2040,92008
920,6845,Single Family - Detached,7214,369,0.05115,2045,92008
921,6807,Multifamily,7301,494,0.06766,2045,92008
922,125,Mobile Home,157,32,0.20382,2045,92008
923,13777,Total Units,14672,895,0.061,2045,92008
924,6845,Single Family - Detached,7219,374,0.05181,2050,92008
925,6802,Multifamily,7301,499,0.06835,2050,92008
926,123,Mobile Home,157,34,0.21656,2050,92008
927,13770,Total Units,14677,907,0.0618,2050,92008
928,10963,Single Family - Detached,11602,639,0.05508,2012,92009
929,4115,Multifamily,4380,265,0.0605,2012,92009
930,0,Mobile Home,0,0,,2012,92009
931,15078,Total Units,15982,904,0.05656,2012,92009
932,11312,Single Family - Detached,12034,722,0.06,2020,92009
933,4213,Multifamily,4484,271,0.06044,2020,92009
934,0,Mobile Home,0,0,,2020,92009
935,15525,Total Units,16518,993,0.06012,2020,92009
936,11456,Single Family - Detached,12041,585,0.04858,2025,92009
937,4288,Multifamily,4527,239,0.05279,2025,92009
938,0,Mobile Home,0,0,,2025,92009
939,15744,Total Units,16568,824,0.04973,2025,92009
940,11450,Single Family - Detached,12048,598,0.04963,2030,92009
941,4315,Multifamily,4557,242,0.05311,2030,92009
942,0,Mobile Home,0,0,,2030,92009
943,15765,Total Units,16605,840,0.05059,2030,92009
944,11527,Single Family - Detached,12081,554,0.04586,2035,92009
945,4350,Multifamily,4586,236,0.05146,2035,92009
946,0,Mobile Home,0,0,,2035,92009
947,15877,Total Units,16667,790,0.0474,2035,92009
948,11525,Single Family - Detached,12082,557,0.0461,2040,92009
949,4340,Multifamily,4586,246,0.05364,2040,92009
950,0,Mobile Home,0,0,,2040,92009
951,15865,Total Units,16668,803,0.04818,2040,92009
952,11515,Single Family - Detached,12082,567,0.04693,2045,92009
953,4338,Multifamily,4586,248,0.05408,2045,92009
954,0,Mobile Home,0,0,,2045,92009
955,15853,Total Units,16668,815,0.0489,2045,92009
956,11513,Single Family - Detached,12088,575,0.04757,2050,92009
957,4336,Multifamily,4586,250,0.05451,2050,92009
958,0,Mobile Home,0,0,,2050,92009
959,15849,Total Units,16674,825,0.04948,2050,92009
960,4458,Single Family - Detached,4640,182,0.03922,2012,92010
961,689,Multifamily,711,22,0.03094,2012,92010
962,441,Mobile Home,501,60,0.11976,2012,92010
963,5588,Total Units,5852,264,0.04511,2012,92010
964,5358,Single Family - Detached,5599,241,0.04304,2020,92010
965,1393,Multifamily,1433,40,0.02791,2020,92010
966,443,Mobile Home,501,58,0.11577,2020,92010
967,7194,Total Units,7533,339,0.045,2020,92010
968,5440,Single Family - Detached,5635,195,0.03461,2025,92010
969,1395,Multifamily,1433,38,0.02652,2025,92010
970,442,Mobile Home,501,59,0.11776,2025,92010
971,7277,Total Units,7569,292,0.03858,2025,92010
972,5447,Single Family - Detached,5647,200,0.03542,2030,92010
973,1395,Multifamily,1433,38,0.02652,2030,92010
974,439,Mobile Home,501,62,0.12375,2030,92010
975,7281,Total Units,7581,300,0.03957,2030,92010
976,5563,Single Family - Detached,5750,187,0.03252,2035,92010
977,1396,Multifamily,1433,37,0.02582,2035,92010
978,439,Mobile Home,501,62,0.12375,2035,92010
979,7398,Total Units,7684,286,0.03722,2035,92010
980,5570,Single Family - Detached,5751,181,0.03147,2040,92010
981,1393,Multifamily,1433,40,0.02791,2040,92010
982,440,Mobile Home,501,61,0.12176,2040,92010
983,7403,Total Units,7685,282,0.03669,2040,92010
984,5565,Single Family - Detached,5751,186,0.03234,2045,92010
985,1392,Multifamily,1433,41,0.02861,2045,92010
986,438,Mobile Home,501,63,0.12575,2045,92010
987,7395,Total Units,7685,290,0.03774,2045,92010
988,5561,Single Family - Detached,5753,192,0.03337,2050,92010
989,1391,Multifamily,1433,42,0.02931,2050,92010
990,429,Mobile Home,501,72,0.14371,2050,92010
991,7381,Total Units,7687,306,0.03981,2050,92010
992,6884,Single Family - Detached,7472,588,0.07869,2012,92011
993,1833,Multifamily,1956,123,0.06288,2012,92011
994,480,Mobile Home,657,177,0.26941,2012,92011
995,9197,Total Units,10085,888,0.08805,2012,92011
996,7078,Single Family - Detached,7722,644,0.0834,2020,92011
997,1991,Multifamily,2126,135,0.0635,2020,92011
998,482,Mobile Home,657,175,0.26636,2020,92011
999,9551,Total Units,10505,954,0.09081,2020,92011
1000,7249,Single Family - Detached,7778,529,0.06801,2025,92011
1001,2002,Multifamily,2129,127,0.05965,2025,92011
1002,481,Mobile Home,657,176,0.26788,2025,92011
1003,9732,Total Units,10564,832,0.07876,2025,92011
1004,7299,Single Family - Detached,7843,544,0.06936,2030,92011
1005,2003,Multifamily,2131,128,0.06007,2030,92011
1006,478,Mobile Home,657,179,0.27245,2030,92011
1007,9780,Total Units,10631,851,0.08005,2030,92011
1008,7450,Single Family - Detached,7962,512,0.06431,2035,92011
1009,2009,Multifamily,2133,124,0.05813,2035,92011
1010,478,Mobile Home,657,179,0.27245,2035,92011
1011,9937,Total Units,10752,815,0.0758,2035,92011
1012,7441,Single Family - Detached,7962,521,0.06544,2040,92011
1013,2009,Multifamily,2140,131,0.06121,2040,92011
1014,479,Mobile Home,657,178,0.27093,2040,92011
1015,9929,Total Units,10759,830,0.07714,2040,92011
1016,7434,Single Family - Detached,7962,528,0.06631,2045,92011
1017,2008,Multifamily,2140,132,0.06168,2045,92011
1018,477,Mobile Home,657,180,0.27397,2045,92011
1019,9919,Total Units,10759,840,0.07807,2045,92011
1020,7434,Single Family - Detached,7962,528,0.06631,2050,92011
1021,2007,Multifamily,2140,133,0.06215,2050,92011
1022,467,Mobile Home,657,190,0.28919,2050,92011
1023,9908,Total Units,10759,851,0.0791,2050,92011
1024,4765,Single Family - Detached,5442,677,0.1244,2012,92014
1025,1292,Multifamily,1414,122,0.08628,2012,92014
1026,0,Mobile Home,0,0,,2012,92014
1027,6057,Total Units,6856,799,0.11654,2012,92014
1028,4783,Single Family - Detached,5469,686,0.12543,2020,92014
1029,1309,Multifamily,1415,106,0.07491,2020,92014
1030,0,Mobile Home,0,0,,2020,92014
1031,6092,Total Units,6884,792,0.11505,2020,92014
1032,4918,Single Family - Detached,5481,563,0.10272,2025,92014
1033,1326,Multifamily,1417,91,0.06422,2025,92014
1034,0,Mobile Home,0,0,,2025,92014
1035,6244,Total Units,6898,654,0.09481,2025,92014
1036,4911,Single Family - Detached,5487,576,0.10498,2030,92014
1037,1355,Multifamily,1447,92,0.06358,2030,92014
1038,0,Mobile Home,0,0,,2030,92014
1039,6266,Total Units,6934,668,0.09634,2030,92014
1040,4970,Single Family - Detached,5510,540,0.098,2035,92014
1041,1362,Multifamily,1449,87,0.06004,2035,92014
1042,0,Mobile Home,0,0,,2035,92014
1043,6332,Total Units,6959,627,0.0901,2035,92014
1044,5021,Single Family - Detached,5516,495,0.08974,2040,92014
1045,1468,Multifamily,1562,94,0.06018,2040,92014
1046,0,Mobile Home,0,0,,2040,92014
1047,6489,Total Units,7078,589,0.08322,2040,92014
1048,4987,Single Family - Detached,5523,536,0.09705,2045,92014
1049,1534,Multifamily,1633,99,0.06062,2045,92014
1050,0,Mobile Home,0,0,,2045,92014
1051,6521,Total Units,7156,635,0.08874,2045,92014
1052,4988,Single Family - Detached,5539,551,0.09948,2050,92014
1053,1539,Multifamily,1641,102,0.06216,2050,92014
1054,0,Mobile Home,0,0,,2050,92014
1055,6527,Total Units,7180,653,0.09095,2050,92014
1056,9746,Single Family - Detached,10003,257,0.02569,2012,92019
1057,4568,Multifamily,4801,233,0.04853,2012,92019
1058,816,Mobile Home,868,52,0.05991,2012,92019
1059,15130,Total Units,15672,542,0.03458,2012,92019
1060,9845,Single Family - Detached,10143,298,0.02938,2020,92019
1061,4542,Multifamily,4801,259,0.05395,2020,92019
1062,817,Mobile Home,868,51,0.05876,2020,92019
1063,15204,Total Units,15812,608,0.03845,2020,92019
1064,10119,Single Family - Detached,10389,270,0.02599,2025,92019
1065,4584,Multifamily,4801,217,0.0452,2025,92019
1066,818,Mobile Home,868,50,0.0576,2025,92019
1067,15521,Total Units,16058,537,0.03344,2025,92019
1068,10321,Single Family - Detached,10585,264,0.02494,2030,92019
1069,4581,Multifamily,4801,220,0.04582,2030,92019
1070,804,Mobile Home,861,57,0.0662,2030,92019
1071,15706,Total Units,16247,541,0.0333,2030,92019
1072,10364,Single Family - Detached,10619,255,0.02401,2035,92019
1073,4593,Multifamily,4801,208,0.04332,2035,92019
1074,804,Mobile Home,853,49,0.05744,2035,92019
1075,15761,Total Units,16273,512,0.03146,2035,92019
1076,10439,Single Family - Detached,10717,278,0.02594,2040,92019
1077,4737,Multifamily,4967,230,0.04631,2040,92019
1078,787,Mobile Home,835,48,0.05749,2040,92019
1079,15963,Total Units,16519,556,0.03366,2040,92019
1080,10525,Single Family - Detached,10828,303,0.02798,2045,92019
1081,4722,Multifamily,4967,245,0.04933,2045,92019
1082,782,Mobile Home,835,53,0.06347,2045,92019
1083,16029,Total Units,16630,601,0.03614,2045,92019
1084,10552,Single Family - Detached,10859,307,0.02827,2050,92019
1085,4717,Multifamily,4967,250,0.05033,2050,92019
1086,763,Mobile Home,835,72,0.08623,2050,92019
1087,16032,Total Units,16661,629,0.03775,2050,92019
1088,9357,Single Family - Detached,9615,258,0.02683,2012,92020
1089,10609,Multifamily,11029,420,0.03808,2012,92020
1090,560,Mobile Home,570,10,0.01754,2012,92020
1091,20526,Total Units,21214,688,0.03243,2012,92020
1092,9422,Single Family - Detached,9699,277,0.02856,2020,92020
1093,10662,Multifamily,11061,399,0.03607,2020,92020
1094,560,Mobile Home,570,10,0.01754,2020,92020
1095,20644,Total Units,21330,686,0.03216,2020,92020
1096,9681,Single Family - Detached,9914,233,0.0235,2025,92020
1097,11123,Multifamily,11483,360,0.03135,2025,92020
1098,560,Mobile Home,570,10,0.01754,2025,92020
1099,21364,Total Units,21967,603,0.02745,2025,92020
1100,9618,Single Family - Detached,9867,249,0.02524,2030,92020
1101,12102,Multifamily,12506,404,0.0323,2030,92020
1102,558,Mobile Home,570,12,0.02105,2030,92020
1103,22278,Total Units,22943,665,0.02898,2030,92020
1104,9663,Single Family - Detached,9889,226,0.02285,2035,92020
1105,12842,Multifamily,13255,413,0.03116,2035,92020
1106,559,Mobile Home,570,11,0.0193,2035,92020
1107,23064,Total Units,23714,650,0.02741,2035,92020
1108,9513,Single Family - Detached,9769,256,0.02621,2040,92020
1109,14113,Multifamily,14637,524,0.0358,2040,92020
1110,562,Mobile Home,570,8,0.01404,2040,92020
1111,24188,Total Units,24976,788,0.03155,2040,92020
1112,9424,Single Family - Detached,9706,282,0.02905,2045,92020
1113,14794,Multifamily,15374,580,0.03773,2045,92020
1114,561,Mobile Home,570,9,0.01579,2045,92020
1115,24779,Total Units,25650,871,0.03396,2045,92020
1116,9362,Single Family - Detached,9651,289,0.02995,2050,92020
1117,15308,Multifamily,15929,621,0.03899,2050,92020
1118,554,Mobile Home,570,16,0.02807,2050,92020
1119,25224,Total Units,26150,926,0.03541,2050,92020
1120,10762,Single Family - Detached,11366,604,0.05314,2012,92021
1121,8053,Multifamily,8254,201,0.02435,2012,92021
1122,4170,Mobile Home,4426,256,0.05784,2012,92021
1123,22985,Total Units,24046,1061,0.04412,2012,92021
1124,11481,Single Family - Detached,12169,688,0.05654,2020,92021
1125,8160,Multifamily,8356,196,0.02346,2020,92021
1126,3929,Mobile Home,4177,248,0.05937,2020,92021
1127,23570,Total Units,24702,1132,0.04583,2020,92021
1128,13144,Single Family - Detached,13789,645,0.04678,2025,92021
1129,8282,Multifamily,8449,167,0.01977,2025,92021
1130,3865,Mobile Home,4110,245,0.05961,2025,92021
1131,25291,Total Units,26348,1057,0.04012,2025,92021
1132,14654,Single Family - Detached,15343,689,0.04491,2030,92021
1133,8405,Multifamily,8577,172,0.02005,2030,92021
1134,3734,Mobile Home,3986,252,0.06322,2030,92021
1135,26793,Total Units,27906,1113,0.03988,2030,92021
1136,15069,Single Family - Detached,15724,655,0.04166,2035,92021
1137,8427,Multifamily,8593,166,0.01932,2035,92021
1138,3660,Mobile Home,3871,211,0.05451,2035,92021
1139,27156,Total Units,28188,1032,0.03661,2035,92021
1140,15334,Single Family - Detached,16053,719,0.04479,2040,92021
1141,8966,Multifamily,9152,186,0.02032,2040,92021
1142,3505,Mobile Home,3687,182,0.04936,2040,92021
1143,27805,Total Units,28892,1087,0.03762,2040,92021
1144,15386,Single Family - Detached,16194,808,0.0499,2045,92021
1145,9227,Multifamily,9478,251,0.02648,2045,92021
1146,3421,Mobile Home,3621,200,0.05523,2045,92021
1147,28034,Total Units,29293,1259,0.04298,2045,92021
1148,15422,Single Family - Detached,16266,844,0.05189,2050,92021
1149,9219,Multifamily,9478,259,0.02733,2050,92021
1150,3311,Mobile Home,3590,279,0.07772,2050,92021
1151,27952,Total Units,29334,1382,0.04711,2050,92021
1152,16300,Single Family - Detached,16950,650,0.03835,2012,92024
1153,4227,Multifamily,4452,225,0.05054,2012,92024
1154,735,Mobile Home,776,41,0.05284,2012,92024
1155,21262,Total Units,22178,916,0.0413,2012,92024
1156,16760,Single Family - Detached,17507,747,0.04267,2020,92024
1157,4432,Multifamily,4658,226,0.04852,2020,92024
1158,738,Mobile Home,776,38,0.04897,2020,92024
1159,21930,Total Units,22941,1011,0.04407,2020,92024
1160,16981,Single Family - Detached,17570,589,0.03352,2025,92024
1161,4658,Multifamily,4868,210,0.04314,2025,92024
1162,737,Mobile Home,776,39,0.05026,2025,92024
1163,22376,Total Units,23214,838,0.0361,2025,92024
1164,17056,Single Family - Detached,17665,609,0.03447,2030,92024
1165,4717,Multifamily,4934,217,0.04398,2030,92024
1166,733,Mobile Home,776,43,0.05541,2030,92024
1167,22506,Total Units,23375,869,0.03718,2030,92024
1168,17164,Single Family - Detached,17751,587,0.03307,2035,92024
1169,4734,Multifamily,4945,211,0.04267,2035,92024
1170,733,Mobile Home,776,43,0.05541,2035,92024
1171,22631,Total Units,23472,841,0.03583,2035,92024
1172,17186,Single Family - Detached,17842,656,0.03677,2040,92024
1173,4901,Multifamily,5138,237,0.04613,2040,92024
1174,735,Mobile Home,776,41,0.05284,2040,92024
1175,22822,Total Units,23756,934,0.03932,2040,92024
1176,17163,Single Family - Detached,17889,726,0.04058,2045,92024
1177,5100,Multifamily,5365,265,0.04939,2045,92024
1178,732,Mobile Home,776,44,0.0567,2045,92024
1179,22995,Total Units,24030,1035,0.04307,2045,92024
1180,17162,Single Family - Detached,17911,749,0.04182,2050,92024
1181,5309,Multifamily,5600,291,0.05196,2050,92024
1182,717,Mobile Home,776,59,0.07603,2050,92024
1183,23188,Total Units,24287,1099,0.04525,2050,92024
1184,9075,Single Family - Detached,9360,285,0.03045,2012,92025
1185,5285,Multifamily,5741,456,0.07943,2012,92025
1186,283,Mobile Home,296,13,0.04392,2012,92025
1187,14643,Total Units,15397,754,0.04897,2012,92025
1188,9314,Single Family - Detached,9630,316,0.03281,2020,92025
1189,9472,Multifamily,10238,766,0.07482,2020,92025
1190,285,Mobile Home,296,11,0.03716,2020,92025
1191,19071,Total Units,20164,1093,0.05421,2020,92025
1192,9283,Single Family - Detached,9526,243,0.02551,2025,92025
1193,10925,Multifamily,11674,749,0.06416,2025,92025
1194,285,Mobile Home,296,11,0.03716,2025,92025
1195,20493,Total Units,21496,1003,0.04666,2025,92025
1196,9292,Single Family - Detached,9537,245,0.02569,2030,92025
1197,11072,Multifamily,11829,757,0.064,2030,92025
1198,284,Mobile Home,296,12,0.04054,2030,92025
1199,20648,Total Units,21662,1014,0.04681,2030,92025
1200,9364,Single Family - Detached,9581,217,0.02265,2035,92025
1201,11295,Multifamily,12017,722,0.06008,2035,92025
1202,284,Mobile Home,296,12,0.04054,2035,92025
1203,20943,Total Units,21894,951,0.04344,2035,92025
1204,9346,Single Family - Detached,9573,227,0.02371,2040,92025
1205,11440,Multifamily,12071,631,0.05227,2040,92025
1206,284,Mobile Home,296,12,0.04054,2040,92025
1207,21070,Total Units,21940,870,0.03965,2040,92025
1208,9305,Single Family - Detached,9558,253,0.02647,2045,92025
1209,11658,Multifamily,12329,671,0.05442,2045,92025
1210,283,Mobile Home,296,13,0.04392,2045,92025
1211,21246,Total Units,22183,937,0.04224,2045,92025
1212,9346,Single Family - Detached,9606,260,0.02707,2050,92025
1213,11589,Multifamily,12265,676,0.05512,2050,92025
1214,277,Mobile Home,296,19,0.06419,2050,92025
1215,21212,Total Units,22167,955,0.04308,2050,92025
1216,11164,Single Family - Detached,11622,458,0.03941,2012,92026
1217,5350,Multifamily,5711,361,0.06321,2012,92026
1218,1360,Mobile Home,1664,304,0.18269,2012,92026
1219,17874,Total Units,18997,1123,0.05911,2012,92026
1220,11708,Single Family - Detached,12221,513,0.04198,2020,92026
1221,5350,Multifamily,5712,362,0.06338,2020,92026
1222,1363,Mobile Home,1664,301,0.18089,2020,92026
1223,18421,Total Units,19597,1176,0.06001,2020,92026
1224,12286,Single Family - Detached,12717,431,0.03389,2025,92026
1225,5448,Multifamily,5773,325,0.0563,2025,92026
1226,1363,Mobile Home,1664,301,0.18089,2025,92026
1227,19097,Total Units,20154,1057,0.05245,2025,92026
1228,12536,Single Family - Detached,12981,445,0.03428,2030,92026
1229,5453,Multifamily,5779,326,0.05641,2030,92026
1230,1356,Mobile Home,1664,308,0.1851,2030,92026
1231,19345,Total Units,20424,1079,0.05283,2030,92026
1232,12737,Single Family - Detached,13157,420,0.03192,2035,92026
1233,5463,Multifamily,5783,320,0.05533,2035,92026
1234,1356,Mobile Home,1664,308,0.1851,2035,92026
1235,19556,Total Units,20604,1048,0.05086,2035,92026
1236,12870,Single Family - Detached,13342,472,0.03538,2040,92026
1237,5467,Multifamily,5787,320,0.0553,2040,92026
1238,1358,Mobile Home,1664,306,0.18389,2040,92026
1239,19695,Total Units,20793,1098,0.05281,2040,92026
1240,12887,Single Family - Detached,13396,509,0.038,2045,92026
1241,5466,Multifamily,5789,323,0.0558,2045,92026
1242,1353,Mobile Home,1664,311,0.1869,2045,92026
1243,19706,Total Units,20849,1143,0.05482,2045,92026
1244,12965,Single Family - Detached,13492,527,0.03906,2050,92026
1245,5463,Multifamily,5789,326,0.05631,2050,92026
1246,1330,Mobile Home,1664,334,0.20072,2050,92026
1247,19758,Total Units,20945,1187,0.05667,2050,92026
1248,10769,Single Family - Detached,11070,301,0.02719,2012,92027
1249,4144,Multifamily,4470,326,0.07293,2012,92027
1250,1521,Mobile Home,1672,151,0.09031,2012,92027
1251,16434,Total Units,17212,778,0.0452,2012,92027
1252,11271,Single Family - Detached,11633,362,0.03112,2020,92027
1253,4135,Multifamily,4470,335,0.07494,2020,92027
1254,1526,Mobile Home,1672,146,0.08732,2020,92027
1255,16932,Total Units,17775,843,0.04743,2020,92027
1256,11448,Single Family - Detached,11736,288,0.02454,2025,92027
1257,4170,Multifamily,4470,300,0.06711,2025,92027
1258,1525,Mobile Home,1672,147,0.08792,2025,92027
1259,17143,Total Units,17878,735,0.04111,2025,92027
1260,11560,Single Family - Detached,11868,308,0.02595,2030,92027
1261,4158,Multifamily,4470,312,0.0698,2030,92027
1262,1516,Mobile Home,1672,156,0.0933,2030,92027
1263,17234,Total Units,18010,776,0.04309,2030,92027
1264,11754,Single Family - Detached,12042,288,0.02392,2035,92027
1265,4188,Multifamily,4484,296,0.06601,2035,92027
1266,1517,Mobile Home,1672,155,0.0927,2035,92027
1267,17459,Total Units,18198,739,0.04061,2035,92027
1268,11910,Single Family - Detached,12183,273,0.02241,2040,92027
1269,4277,Multifamily,4528,251,0.05543,2040,92027
1270,1519,Mobile Home,1672,153,0.09151,2040,92027
1271,17706,Total Units,18383,677,0.03683,2040,92027
1272,11917,Single Family - Detached,12218,301,0.02464,2045,92027
1273,4294,Multifamily,4563,269,0.05895,2045,92027
1274,1512,Mobile Home,1672,160,0.09569,2045,92027
1275,17723,Total Units,18453,730,0.03956,2045,92027
1276,11950,Single Family - Detached,12259,309,0.02521,2050,92027
1277,4290,Multifamily,4563,273,0.05983,2050,92027
1278,1482,Mobile Home,1672,190,0.11364,2050,92027
1279,17722,Total Units,18494,772,0.04174,2050,92027
1280,13011,Single Family - Detached,13538,527,0.03893,2012,92028
1281,2631,Multifamily,2820,189,0.06702,2012,92028
1282,873,Mobile Home,929,56,0.06028,2012,92028
1283,16515,Total Units,17287,772,0.04466,2012,92028
1284,14537,Single Family - Detached,15171,634,0.04179,2020,92028
1285,2634,Multifamily,2821,187,0.06629,2020,92028
1286,839,Mobile Home,892,53,0.05942,2020,92028
1287,18010,Total Units,18884,874,0.04628,2020,92028
1288,15173,Single Family - Detached,15691,518,0.03301,2025,92028
1289,2662,Multifamily,2826,164,0.05803,2025,92028
1290,839,Mobile Home,892,53,0.05942,2025,92028
1291,18674,Total Units,19409,735,0.03787,2025,92028
1292,16047,Single Family - Detached,16607,560,0.03372,2030,92028
1293,2666,Multifamily,2833,167,0.05895,2030,92028
1294,800,Mobile Home,852,52,0.06103,2030,92028
1295,19513,Total Units,20292,779,0.03839,2030,92028
1296,17332,Single Family - Detached,17879,547,0.03059,2035,92028
1297,2683,Multifamily,2840,157,0.05528,2035,92028
1298,800,Mobile Home,852,52,0.06103,2035,92028
1299,20815,Total Units,21571,756,0.03505,2035,92028
1300,17455,Single Family - Detached,18066,611,0.03382,2040,92028
1301,2933,Multifamily,3119,186,0.05963,2040,92028
1302,762,Mobile Home,804,42,0.05224,2040,92028
1303,21150,Total Units,21989,839,0.03816,2040,92028
1304,17550,Single Family - Detached,18237,687,0.03767,2045,92028
1305,3119,Multifamily,3329,210,0.06308,2045,92028
1306,758,Mobile Home,804,46,0.05721,2045,92028
1307,21427,Total Units,22370,943,0.04215,2045,92028
1308,17579,Single Family - Detached,18288,709,0.03877,2050,92028
1309,3095,Multifamily,3310,215,0.06495,2050,92028
1310,734,Mobile Home,793,59,0.0744,2050,92028
1311,21408,Total Units,22391,983,0.0439,2050,92028
1312,4989,Single Family - Detached,5085,96,0.01888,2012,92029
1313,1057,Multifamily,1084,27,0.02491,2012,92029
1314,987,Mobile Home,1005,18,0.01791,2012,92029
1315,7033,Total Units,7174,141,0.01965,2012,92029
1316,5780,Single Family - Detached,5940,160,0.02694,2020,92029
1317,1061,Multifamily,1092,31,0.02839,2020,92029
1318,989,Mobile Home,1005,16,0.01592,2020,92029
1319,7830,Total Units,8037,207,0.02576,2020,92029
1320,6320,Single Family - Detached,6456,136,0.02107,2025,92029
1321,1066,Multifamily,1094,28,0.02559,2025,92029
1322,987,Mobile Home,1005,18,0.01791,2025,92029
1323,8373,Total Units,8555,182,0.02127,2025,92029
1324,6680,Single Family - Detached,6825,145,0.02125,2030,92029
1325,1064,Multifamily,1095,31,0.02831,2030,92029
1326,982,Mobile Home,1005,23,0.02289,2030,92029
1327,8726,Total Units,8925,199,0.0223,2030,92029
1328,6778,Single Family - Detached,6925,147,0.02123,2035,92029
1329,1067,Multifamily,1096,29,0.02646,2035,92029
1330,982,Mobile Home,1005,23,0.02289,2035,92029
1331,8827,Total Units,9026,199,0.02205,2035,92029
1332,6769,Single Family - Detached,6945,176,0.02534,2040,92029
1333,1065,Multifamily,1096,31,0.02828,2040,92029
1334,985,Mobile Home,1005,20,0.0199,2040,92029
1335,8819,Total Units,9046,227,0.02509,2040,92029
1336,6747,Single Family - Detached,6947,200,0.02879,2045,92029
1337,1061,Multifamily,1098,37,0.0337,2045,92029
1338,980,Mobile Home,1005,25,0.02488,2045,92029
1339,8788,Total Units,9050,262,0.02895,2045,92029
1340,6746,Single Family - Detached,6956,210,0.03019,2050,92029
1341,1060,Multifamily,1098,38,0.03461,2050,92029
1342,960,Mobile Home,1005,45,0.04478,2050,92029
1343,8766,Total Units,9059,293,0.03234,2050,92029
1344,1560,Single Family - Detached,2092,532,0.2543,2012,92036
1345,59,Multifamily,68,9,0.13235,2012,92036
1346,19,Mobile Home,19,0,0.0,2012,92036
1347,1638,Total Units,2179,541,0.24828,2012,92036
1348,1759,Single Family - Detached,2357,598,0.25371,2020,92036
1349,65,Multifamily,68,3,0.04412,2020,92036
1350,19,Mobile Home,19,0,0.0,2020,92036
1351,1843,Total Units,2444,601,0.24591,2020,92036
1352,1846,Single Family - Detached,2366,520,0.21978,2025,92036
1353,66,Multifamily,68,2,0.02941,2025,92036
1354,18,Mobile Home,19,1,0.05263,2025,92036
1355,1930,Total Units,2453,523,0.21321,2025,92036
1356,1904,Single Family - Detached,2460,556,0.22602,2030,92036
1357,64,Multifamily,68,4,0.05882,2030,92036
1358,18,Mobile Home,19,1,0.05263,2030,92036
1359,1986,Total Units,2547,561,0.22026,2030,92036
1360,1985,Single Family - Detached,2526,541,0.21417,2035,92036
1361,66,Multifamily,68,2,0.02941,2035,92036
1362,19,Mobile Home,19,0,0.0,2035,92036
1363,2070,Total Units,2613,543,0.20781,2035,92036
1364,1983,Single Family - Detached,2526,543,0.21496,2040,92036
1365,66,Multifamily,68,2,0.02941,2040,92036
1366,19,Mobile Home,19,0,0.0,2040,92036
1367,2068,Total Units,2613,545,0.20857,2040,92036
1368,1957,Single Family - Detached,2530,573,0.22648,2045,92036
1369,66,Multifamily,68,2,0.02941,2045,92036
1370,18,Mobile Home,19,1,0.05263,2045,92036
1371,2041,Total Units,2617,576,0.2201,2045,92036
1372,1956,Single Family - Detached,2538,582,0.22931,2050,92036
1373,65,Multifamily,68,3,0.04412,2050,92036
1374,18,Mobile Home,19,1,0.05263,2050,92036
1375,2039,Total Units,2625,586,0.22324,2050,92036
1376,10160,Single Family - Detached,11167,1007,0.09018,2012,92037
1377,7658,Multifamily,8939,1281,0.1433,2012,92037
1378,0,Mobile Home,0,0,,2012,92037
1379,17818,Total Units,20106,2288,0.1138,2012,92037
1380,10081,Single Family - Detached,11172,1091,0.09765,2020,92037
1381,8166,Multifamily,9568,1402,0.14653,2020,92037
1382,0,Mobile Home,0,0,,2020,92037
1383,18247,Total Units,20740,2493,0.1202,2020,92037
1384,10298,Single Family - Detached,11192,894,0.07988,2025,92037
1385,8550,Multifamily,9841,1291,0.13119,2025,92037
1386,0,Mobile Home,0,0,,2025,92037
1387,18848,Total Units,21033,2185,0.10388,2025,92037
1388,10294,Single Family - Detached,11211,917,0.08179,2030,92037
1389,9477,Multifamily,11008,1531,0.13908,2030,92037
1390,0,Mobile Home,0,0,,2030,92037
1391,19771,Total Units,22219,2448,0.11018,2030,92037
1392,10333,Single Family - Detached,11182,849,0.07593,2035,92037
1393,10230,Multifamily,11830,1600,0.13525,2035,92037
1394,0,Mobile Home,0,0,,2035,92037
1395,20563,Total Units,23012,2449,0.10642,2035,92037
1396,10313,Single Family - Detached,11224,911,0.08117,2040,92037
1397,10670,Multifamily,12462,1792,0.1438,2040,92037
1398,0,Mobile Home,0,0,,2040,92037
1399,20983,Total Units,23686,2703,0.11412,2040,92037
1400,10195,Single Family - Detached,11185,990,0.08851,2045,92037
1401,11035,Multifamily,13007,1972,0.15161,2045,92037
1402,0,Mobile Home,0,0,,2045,92037
1403,21230,Total Units,24192,2962,0.12244,2045,92037
1404,10171,Single Family - Detached,11189,1018,0.09098,2050,92037
1405,11021,Multifamily,13029,2008,0.15412,2050,92037
1406,0,Mobile Home,0,0,,2050,92037
1407,21192,Total Units,24218,3026,0.12495,2050,92037
1408,9439,Single Family - Detached,9739,300,0.0308,2012,92040
1409,3366,Multifamily,3608,242,0.06707,2012,92040
1410,1793,Mobile Home,1909,116,0.06076,2012,92040
1411,14598,Total Units,15256,658,0.04313,2012,92040
1412,10933,Single Family - Detached,11338,405,0.03572,2020,92040
1413,3302,Multifamily,3534,232,0.06565,2020,92040
1414,1766,Mobile Home,1864,98,0.05258,2020,92040
1415,16001,Total Units,16736,735,0.04392,2020,92040
1416,12427,Single Family - Detached,12768,341,0.02671,2025,92040
1417,3308,Multifamily,3521,213,0.06049,2025,92040
1418,1764,Mobile Home,1864,100,0.05365,2025,92040
1419,17499,Total Units,18153,654,0.03603,2025,92040
1420,13772,Single Family - Detached,14210,438,0.03082,2030,92040
1421,3308,Multifamily,3525,217,0.06156,2030,92040
1422,1756,Mobile Home,1864,108,0.05794,2030,92040
1423,18836,Total Units,19599,763,0.03893,2030,92040
1424,14051,Single Family - Detached,14462,411,0.02842,2035,92040
1425,3312,Multifamily,3525,213,0.06043,2035,92040
1426,1748,Mobile Home,1850,102,0.05514,2035,92040
1427,19111,Total Units,19837,726,0.0366,2035,92040
1428,14244,Single Family - Detached,14716,472,0.03207,2040,92040
1429,3350,Multifamily,3579,229,0.06398,2040,92040
1430,1750,Mobile Home,1850,100,0.05405,2040,92040
1431,19344,Total Units,20145,801,0.03976,2040,92040
1432,14222,Single Family - Detached,14745,523,0.03547,2045,92040
1433,4717,Multifamily,4976,259,0.05205,2045,92040
1434,1745,Mobile Home,1850,105,0.05676,2045,92040
1435,20684,Total Units,21571,887,0.04112,2045,92040
1436,14260,Single Family - Detached,14799,539,0.03642,2050,92040
1437,4716,Multifamily,4976,260,0.05225,2050,92040
1438,1719,Mobile Home,1850,131,0.07081,2050,92040
1439,20695,Total Units,21625,930,0.04301,2050,92040
1440,6903,Single Family - Detached,7606,703,0.09243,2012,92054
1441,6896,Multifamily,8263,1367,0.16544,2012,92054
1442,823,Mobile Home,1245,422,0.33896,2012,92054
1443,14622,Total Units,17114,2492,0.14561,2012,92054
1444,6871,Single Family - Detached,7646,775,0.10136,2020,92054
1445,7675,Multifamily,9314,1639,0.17597,2020,92054
1446,679,Mobile Home,1036,357,0.34459,2020,92054
1447,15225,Total Units,17996,2771,0.15398,2020,92054
1448,7056,Single Family - Detached,7673,617,0.08041,2025,92054
1449,8191,Multifamily,9679,1488,0.15373,2025,92054
1450,678,Mobile Home,1036,358,0.34556,2025,92054
1451,15925,Total Units,18388,2463,0.13395,2025,92054
1452,7055,Single Family - Detached,7686,631,0.0821,2030,92054
1453,8860,Multifamily,10401,1541,0.14816,2030,92054
1454,674,Mobile Home,1036,362,0.34942,2030,92054
1455,16589,Total Units,19123,2534,0.13251,2030,92054
1456,7125,Single Family - Detached,7695,570,0.07407,2035,92054
1457,9540,Multifamily,11070,1530,0.13821,2035,92054
1458,675,Mobile Home,1036,361,0.34846,2035,92054
1459,17340,Total Units,19801,2461,0.12429,2035,92054
1460,7106,Single Family - Detached,7702,596,0.07738,2040,92054
1461,9738,Multifamily,11097,1359,0.12247,2040,92054
1462,692,Mobile Home,1032,340,0.32946,2040,92054
1463,17536,Total Units,19831,2295,0.11573,2040,92054
1464,7099,Single Family - Detached,7702,603,0.07829,2045,92054
1465,9746,Multifamily,11183,1437,0.1285,2045,92054
1466,689,Mobile Home,1032,343,0.33236,2045,92054
1467,17534,Total Units,19917,2383,0.11965,2045,92054
1468,7081,Single Family - Detached,7704,623,0.08087,2050,92054
1469,9755,Multifamily,11226,1471,0.13104,2050,92054
1470,676,Mobile Home,1032,356,0.34496,2050,92054
1471,17512,Total Units,19962,2450,0.12273,2050,92054
1472,4352,Single Family - Detached,5329,977,0.18334,2012,92055
1473,598,Multifamily,675,77,0.11407,2012,92055
1474,0,Mobile Home,0,0,,2012,92055
1475,4950,Total Units,6004,1054,0.17555,2012,92055
1476,4349,Single Family - Detached,5329,980,0.1839,2020,92055
1477,2068,Multifamily,2342,274,0.11699,2020,92055
1478,0,Mobile Home,0,0,,2020,92055
1479,6417,Total Units,7671,1254,0.16347,2020,92055
1480,4353,Single Family - Detached,5329,976,0.18315,2025,92055
1481,2070,Multifamily,2342,272,0.11614,2025,92055
1482,0,Mobile Home,0,0,,2025,92055
1483,6423,Total Units,7671,1248,0.16269,2025,92055
1484,4352,Single Family - Detached,5329,977,0.18334,2030,92055
1485,2070,Multifamily,2342,272,0.11614,2030,92055
1486,0,Mobile Home,0,0,,2030,92055
1487,6422,Total Units,7671,1249,0.16282,2030,92055
1488,4355,Single Family - Detached,5329,974,0.18277,2035,92055
1489,2072,Multifamily,2342,270,0.11529,2035,92055
1490,0,Mobile Home,0,0,,2035,92055
1491,6427,Total Units,7671,1244,0.16217,2035,92055
1492,4350,Single Family - Detached,5329,979,0.18371,2040,92055
1493,2067,Multifamily,2342,275,0.11742,2040,92055
1494,0,Mobile Home,0,0,,2040,92055
1495,6417,Total Units,7671,1254,0.16347,2040,92055
1496,4347,Single Family - Detached,5329,982,0.18427,2045,92055
1497,2066,Multifamily,2342,276,0.11785,2045,92055
1498,0,Mobile Home,0,0,,2045,92055
1499,6413,Total Units,7671,1258,0.16399,2045,92055
1500,4348,Single Family - Detached,5329,981,0.18409,2050,92055
1501,2065,Multifamily,2342,277,0.11827,2050,92055
1502,0,Mobile Home,0,0,,2050,92055
1503,6413,Total Units,7671,1258,0.16399,2050,92055
1504,14857,Single Family - Detached,15594,737,0.04726,2012,92056
1505,4216,Multifamily,4463,247,0.05534,2012,92056
1506,319,Mobile Home,325,6,0.01846,2012,92056
1507,19392,Total Units,20382,990,0.04857,2012,92056
1508,15130,Single Family - Detached,15965,835,0.0523,2020,92056
1509,4629,Multifamily,4863,234,0.04812,2020,92056
1510,320,Mobile Home,325,5,0.01538,2020,92056
1511,20079,Total Units,21153,1074,0.05077,2020,92056
1512,15486,Single Family - Detached,16142,656,0.04064,2025,92056
1513,4713,Multifamily,4940,227,0.04595,2025,92056
1514,320,Mobile Home,325,5,0.01538,2025,92056
1515,20519,Total Units,21407,888,0.04148,2025,92056
1516,15589,Single Family - Detached,16252,663,0.04079,2030,92056
1517,4759,Multifamily,4988,229,0.04591,2030,92056
1518,318,Mobile Home,325,7,0.02154,2030,92056
1519,20666,Total Units,21565,899,0.04169,2030,92056
1520,15669,Single Family - Detached,16283,614,0.03771,2035,92056
1521,4808,Multifamily,5034,226,0.04489,2035,92056
1522,318,Mobile Home,325,7,0.02154,2035,92056
1523,20795,Total Units,21642,847,0.03914,2035,92056
1524,15787,Single Family - Detached,16414,627,0.0382,2040,92056
1525,4820,Multifamily,5058,238,0.04705,2040,92056
1526,319,Mobile Home,325,6,0.01846,2040,92056
1527,20926,Total Units,21797,871,0.03996,2040,92056
1528,15821,Single Family - Detached,16501,680,0.04121,2045,92056
1529,4810,Multifamily,5053,243,0.04809,2045,92056
1530,317,Mobile Home,325,8,0.02462,2045,92056
1531,20948,Total Units,21879,931,0.04255,2045,92056
1532,15834,Single Family - Detached,16527,693,0.04193,2050,92056
1533,4805,Multifamily,5051,246,0.0487,2050,92056
1534,311,Mobile Home,325,14,0.04308,2050,92056
1535,20950,Total Units,21903,953,0.04351,2050,92056
1536,14160,Single Family - Detached,15189,1029,0.06775,2012,92057
1537,3210,Multifamily,3384,174,0.05142,2012,92057
1538,753,Mobile Home,783,30,0.03831,2012,92057
1539,18123,Total Units,19356,1233,0.0637,2012,92057
1540,14437,Single Family - Detached,15578,1141,0.07324,2020,92057
1541,3496,Multifamily,3688,192,0.05206,2020,92057
1542,756,Mobile Home,783,27,0.03448,2020,92057
1543,18689,Total Units,20049,1360,0.06783,2020,92057
1544,14644,Single Family - Detached,15578,934,0.05996,2025,92057
1545,3621,Multifamily,3792,171,0.04509,2025,92057
1546,755,Mobile Home,783,28,0.03576,2025,92057
1547,19020,Total Units,20153,1133,0.05622,2025,92057
1548,14611,Single Family - Detached,15578,967,0.06207,2030,92057
1549,3624,Multifamily,3797,173,0.04556,2030,92057
1550,750,Mobile Home,783,33,0.04215,2030,92057
1551,18985,Total Units,20158,1173,0.05819,2030,92057
1552,14689,Single Family - Detached,15578,889,0.05707,2035,92057
1553,3639,Multifamily,3801,162,0.04262,2035,92057
1554,751,Mobile Home,783,32,0.04087,2035,92057
1555,19079,Total Units,20162,1083,0.05371,2035,92057
1556,14894,Single Family - Detached,15578,684,0.04391,2040,92057
1557,3628,Multifamily,3801,173,0.04551,2040,92057
1558,753,Mobile Home,783,30,0.03831,2040,92057
1559,19275,Total Units,20162,887,0.04399,2040,92057
1560,14817,Single Family - Detached,15578,761,0.04885,2045,92057
1561,3626,Multifamily,3801,175,0.04604,2045,92057
1562,749,Mobile Home,783,34,0.04342,2045,92057
1563,19192,Total Units,20162,970,0.04811,2045,92057
1564,14887,Single Family - Detached,15671,784,0.05003,2050,92057
1565,3622,Multifamily,3801,179,0.04709,2050,92057
1566,733,Mobile Home,783,50,0.06386,2050,92057
1567,19242,Total Units,20255,1013,0.05001,2050,92057
1568,3228,Single Family - Detached,3722,494,0.13272,2012,92058
1569,3503,Multifamily,3651,148,0.04054,2012,92058
1570,1148,Mobile Home,1159,11,0.00949,2012,92058
1571,7879,Total Units,8532,653,0.07654,2012,92058
1572,3202,Single Family - Detached,3722,520,0.13971,2020,92058
1573,3480,Multifamily,3653,173,0.04736,2020,92058
1574,1152,Mobile Home,1159,7,0.00604,2020,92058
1575,7834,Total Units,8534,700,0.08202,2020,92058
1576,3248,Single Family - Detached,3722,474,0.12735,2025,92058
1577,3517,Multifamily,3662,145,0.0396,2025,92058
1578,1151,Mobile Home,1159,8,0.0069,2025,92058
1579,7916,Total Units,8543,627,0.07339,2025,92058
1580,3242,Single Family - Detached,3722,480,0.12896,2030,92058
1581,3536,Multifamily,3694,158,0.04277,2030,92058
1582,1145,Mobile Home,1159,14,0.01208,2030,92058
1583,7923,Total Units,8575,652,0.07603,2030,92058
1584,3252,Single Family - Detached,3722,470,0.12628,2035,92058
1585,3673,Multifamily,3824,151,0.03949,2035,92058
1586,1146,Mobile Home,1159,13,0.01122,2035,92058
1587,8071,Total Units,8705,634,0.07283,2035,92058
1588,3307,Single Family - Detached,3722,415,0.1115,2040,92058
1589,3706,Multifamily,3856,150,0.0389,2040,92058
1590,1148,Mobile Home,1159,11,0.00949,2040,92058
1591,8161,Total Units,8737,576,0.06593,2040,92058
1592,3295,Single Family - Detached,3722,427,0.11472,2045,92058
1593,3704,Multifamily,3856,152,0.03942,2045,92058
1594,1143,Mobile Home,1159,16,0.01381,2045,92058
1595,8142,Total Units,8737,595,0.0681,2045,92058
1596,3282,Single Family - Detached,3722,440,0.11822,2050,92058
1597,3701,Multifamily,3856,155,0.0402,2050,92058
1598,1121,Mobile Home,1159,38,0.03279,2050,92058
1599,8104,Total Units,8737,633,0.07245,2050,92058
1600,494,Single Family - Detached,498,4,0.00803,2012,92059
1601,7,Multifamily,7,0,0.0,2012,92059
1602,0,Mobile Home,0,0,,2012,92059
1603,501,Total Units,505,4,0.00792,2012,92059
1604,517,Single Family - Detached,524,7,0.01336,2020,92059
1605,7,Multifamily,7,0,0.0,2020,92059
1606,0,Mobile Home,0,0,,2020,92059
1607,524,Total Units,531,7,0.01318,2020,92059
1608,530,Single Family - Detached,535,5,0.00935,2025,92059
1609,7,Multifamily,7,0,0.0,2025,92059
1610,0,Mobile Home,0,0,,2025,92059
1611,537,Total Units,542,5,0.00923,2025,92059
1612,533,Single Family - Detached,538,5,0.00929,2030,92059
1613,7,Multifamily,7,0,0.0,2030,92059
1614,0,Mobile Home,0,0,,2030,92059
1615,540,Total Units,545,5,0.00917,2030,92059
1616,547,Single Family - Detached,552,5,0.00906,2035,92059
1617,7,Multifamily,7,0,0.0,2035,92059
1618,0,Mobile Home,0,0,,2035,92059
1619,554,Total Units,559,5,0.00894,2035,92059
1620,552,Single Family - Detached,560,8,0.01429,2040,92059
1621,7,Multifamily,7,0,0.0,2040,92059
1622,0,Mobile Home,0,0,,2040,92059
1623,559,Total Units,567,8,0.01411,2040,92059
1624,566,Single Family - Detached,575,9,0.01565,2045,92059
1625,7,Multifamily,7,0,0.0,2045,92059
1626,0,Mobile Home,0,0,,2045,92059
1627,573,Total Units,582,9,0.01546,2045,92059
1628,567,Single Family - Detached,576,9,0.01563,2050,92059
1629,7,Multifamily,7,0,0.0,2050,92059
1630,0,Mobile Home,0,0,,2050,92059
1631,574,Total Units,583,9,0.01544,2050,92059
1632,274,Single Family - Detached,349,75,0.2149,2012,92060
1633,0,Multifamily,0,0,,2012,92060
1634,0,Mobile Home,0,0,,2012,92060
1635,274,Total Units,349,75,0.2149,2012,92060
1636,303,Single Family - Detached,398,95,0.23869,2020,92060
1637,0,Multifamily,0,0,,2020,92060
1638,0,Mobile Home,0,0,,2020,92060
1639,303,Total Units,398,95,0.23869,2020,92060
1640,324,Single Family - Detached,404,80,0.19802,2025,92060
1641,0,Multifamily,0,0,,2025,92060
1642,0,Mobile Home,0,0,,2025,92060
1643,324,Total Units,404,80,0.19802,2025,92060
1644,327,Single Family - Detached,411,84,0.20438,2030,92060
1645,0,Multifamily,0,0,,2030,92060
1646,0,Mobile Home,0,0,,2030,92060
1647,327,Total Units,411,84,0.20438,2030,92060
1648,375,Single Family - Detached,467,92,0.197,2035,92060
1649,0,Multifamily,0,0,,2035,92060
1650,0,Mobile Home,0,0,,2035,92060
1651,375,Total Units,467,92,0.197,2035,92060
1652,374,Single Family - Detached,467,93,0.19914,2040,92060
1653,0,Multifamily,0,0,,2040,92060
1654,0,Mobile Home,0,0,,2040,92060
1655,374,Total Units,467,93,0.19914,2040,92060
1656,373,Single Family - Detached,467,94,0.20128,2045,92060
1657,0,Multifamily,0,0,,2045,92060
1658,0,Mobile Home,0,0,,2045,92060
1659,373,Total Units,467,94,0.20128,2045,92060
1660,374,Single Family - Detached,467,93,0.19914,2050,92060
1661,0,Multifamily,0,0,,2050,92060
1662,0,Mobile Home,0,0,,2050,92060
1663,374,Total Units,467,93,0.19914,2050,92060
1664,751,Single Family - Detached,790,39,0.04937,2012,92061
1665,0,Multifamily,0,0,,2012,92061
1666,93,Mobile Home,139,46,0.33094,2012,92061
1667,844,Total Units,929,85,0.0915,2012,92061
1668,1074,Single Family - Detached,1095,21,0.01918,2020,92061
1669,0,Multifamily,0,0,,2020,92061
1670,94,Mobile Home,139,45,0.32374,2020,92061
1671,1168,Total Units,1234,66,0.05348,2020,92061
1672,1124,Single Family - Detached,1145,21,0.01834,2025,92061
1673,0,Multifamily,0,0,,2025,92061
1674,94,Mobile Home,139,45,0.32374,2025,92061
1675,1218,Total Units,1284,66,0.0514,2025,92061
1676,1212,Single Family - Detached,1231,19,0.01543,2030,92061
1677,0,Multifamily,0,0,,2030,92061
1678,93,Mobile Home,139,46,0.33094,2030,92061
1679,1305,Total Units,1370,65,0.04745,2030,92061
1680,1407,Single Family - Detached,1430,23,0.01608,2035,92061
1681,0,Multifamily,0,0,,2035,92061
1682,93,Mobile Home,139,46,0.33094,2035,92061
1683,1500,Total Units,1569,69,0.04398,2035,92061
1684,1454,Single Family - Detached,1477,23,0.01557,2040,92061
1685,0,Multifamily,0,0,,2040,92061
1686,93,Mobile Home,139,46,0.33094,2040,92061
1687,1547,Total Units,1616,69,0.0427,2040,92061
1688,1489,Single Family - Detached,1515,26,0.01716,2045,92061
1689,0,Multifamily,0,0,,2045,92061
1690,93,Mobile Home,139,46,0.33094,2045,92061
1691,1582,Total Units,1654,72,0.04353,2045,92061
1692,1489,Single Family - Detached,1519,30,0.01975,2050,92061
1693,0,Multifamily,0,0,,2050,92061
1694,91,Mobile Home,139,48,0.34532,2050,92061
1695,1580,Total Units,1658,78,0.04704,2050,92061
1696,12896,Single Family - Detached,13146,250,0.01902,2012,92064
1697,2664,Multifamily,2731,67,0.02453,2012,92064
1698,693,Mobile Home,702,9,0.01282,2012,92064
1699,16253,Total Units,16579,326,0.01966,2012,92064
1700,13169,Single Family - Detached,13455,286,0.02126,2020,92064
1701,2675,Multifamily,2733,58,0.02122,2020,92064
1702,696,Mobile Home,702,6,0.00855,2020,92064
1703,16540,Total Units,16890,350,0.02072,2020,92064
1704,13309,Single Family - Detached,13530,221,0.01633,2025,92064
1705,2993,Multifamily,3046,53,0.0174,2025,92064
1706,695,Mobile Home,702,7,0.00997,2025,92064
1707,16997,Total Units,17278,281,0.01626,2025,92064
1708,13381,Single Family - Detached,13609,228,0.01675,2030,92064
1709,3077,Multifamily,3133,56,0.01787,2030,92064
1710,690,Mobile Home,702,12,0.01709,2030,92064
1711,17148,Total Units,17444,296,0.01697,2030,92064
1712,13658,Single Family - Detached,13866,208,0.015,2035,92064
1713,3131,Multifamily,3182,51,0.01603,2035,92064
1714,690,Mobile Home,702,12,0.01709,2035,92064
1715,17479,Total Units,17750,271,0.01527,2035,92064
1716,13656,Single Family - Detached,13889,233,0.01678,2040,92064
1717,3131,Multifamily,3192,61,0.01911,2040,92064
1718,692,Mobile Home,702,10,0.01425,2040,92064
1719,17479,Total Units,17783,304,0.01709,2040,92064
1720,13642,Single Family - Detached,13898,256,0.01842,2045,92064
1721,3165,Multifamily,3231,66,0.02043,2045,92064
1722,689,Mobile Home,702,13,0.01852,2045,92064
1723,17496,Total Units,17831,335,0.01879,2045,92064
1724,13725,Single Family - Detached,13985,260,0.01859,2050,92064
1725,3164,Multifamily,3231,67,0.02074,2050,92064
1726,675,Mobile Home,702,27,0.03846,2050,92064
1727,17564,Total Units,17918,354,0.01976,2050,92064
1728,10180,Single Family - Detached,10387,207,0.01993,2012,92065
1729,1476,Multifamily,1565,89,0.05687,2012,92065
1730,463,Mobile Home,482,19,0.03942,2012,92065
1731,12119,Total Units,12434,315,0.02533,2012,92065
1732,10910,Single Family - Detached,11154,244,0.02188,2020,92065
1733,1487,Multifamily,1577,90,0.05707,2020,92065
1734,465,Mobile Home,482,17,0.03527,2020,92065
1735,12862,Total Units,13213,351,0.02656,2020,92065
1736,11221,Single Family - Detached,11412,191,0.01674,2025,92065
1737,1479,Multifamily,1556,77,0.04949,2025,92065
1738,464,Mobile Home,482,18,0.03734,2025,92065
1739,13164,Total Units,13450,286,0.02126,2025,92065
1740,11591,Single Family - Detached,11791,200,0.01696,2030,92065
1741,1502,Multifamily,1581,79,0.04997,2030,92065
1742,462,Mobile Home,482,20,0.04149,2030,92065
1743,13555,Total Units,13854,299,0.02158,2030,92065
1744,12278,Single Family - Detached,12469,191,0.01532,2035,92065
1745,1503,Multifamily,1581,78,0.04934,2035,92065
1746,462,Mobile Home,482,20,0.04149,2035,92065
1747,14243,Total Units,14532,289,0.01989,2035,92065
1748,12404,Single Family - Detached,12622,218,0.01727,2040,92065
1749,1605,Multifamily,1695,90,0.0531,2040,92065
1750,463,Mobile Home,482,19,0.03942,2040,92065
1751,14472,Total Units,14799,327,0.0221,2040,92065
1752,12565,Single Family - Detached,12813,248,0.01936,2045,92065
1753,1876,Multifamily,1990,114,0.05729,2045,92065
1754,461,Mobile Home,482,21,0.04357,2045,92065
1755,14902,Total Units,15285,383,0.02506,2045,92065
1756,12696,Single Family - Detached,12951,255,0.01969,2050,92065
1757,1875,Multifamily,1990,115,0.05779,2050,92065
1758,452,Mobile Home,482,30,0.06224,2050,92065
1759,15023,Total Units,15423,400,0.02594,2050,92065
1760,176,Single Family - Detached,176,0,0.0,2012,92066
1761,0,Multifamily,0,0,,2012,92066
1762,0,Mobile Home,0,0,,2012,92066
1763,176,Total Units,176,0,0.0,2012,92066
1764,194,Single Family - Detached,195,1,0.00513,2020,92066
1765,0,Multifamily,0,0,,2020,92066
1766,0,Mobile Home,0,0,,2020,92066
1767,194,Total Units,195,1,0.00513,2020,92066
1768,212,Single Family - Detached,213,1,0.00469,2025,92066
1769,0,Multifamily,0,0,,2025,92066
1770,0,Mobile Home,0,0,,2025,92066
1771,212,Total Units,213,1,0.00469,2025,92066
1772,251,Single Family - Detached,253,2,0.00791,2030,92066
1773,0,Multifamily,0,0,,2030,92066
1774,0,Mobile Home,0,0,,2030,92066
1775,251,Total Units,253,2,0.00791,2030,92066
1776,252,Single Family - Detached,253,1,0.00395,2035,92066
1777,0,Multifamily,0,0,,2035,92066
1778,0,Mobile Home,0,0,,2035,92066
1779,252,Total Units,253,1,0.00395,2035,92066
1780,252,Single Family - Detached,254,2,0.00787,2040,92066
1781,0,Multifamily,0,0,,2040,92066
1782,0,Mobile Home,0,0,,2040,92066
1783,252,Total Units,254,2,0.00787,2040,92066
1784,253,Single Family - Detached,255,2,0.00784,2045,92066
1785,0,Multifamily,0,0,,2045,92066
1786,0,Mobile Home,0,0,,2045,92066
1787,253,Total Units,255,2,0.00784,2045,92066
1788,256,Single Family - Detached,257,1,0.00389,2050,92066
1789,0,Multifamily,0,0,,2050,92066
1790,0,Mobile Home,0,0,,2050,92066
1791,256,Total Units,257,1,0.00389,2050,92066
1792,3385,Single Family - Detached,3825,440,0.11503,2012,92067
1793,42,Multifamily,61,19,0.31148,2012,92067
1794,0,Mobile Home,0,0,,2012,92067
1795,3427,Total Units,3886,459,0.11812,2012,92067
1796,3543,Single Family - Detached,4039,496,0.1228,2020,92067
1797,50,Multifamily,61,11,0.18033,2020,92067
1798,0,Mobile Home,0,0,,2020,92067
1799,3593,Total Units,4100,507,0.12366,2020,92067
1800,3760,Single Family - Detached,4155,395,0.09507,2025,92067
1801,51,Multifamily,61,10,0.16393,2025,92067
1802,0,Mobile Home,0,0,,2025,92067
1803,3811,Total Units,4216,405,0.09606,2025,92067
1804,4058,Single Family - Detached,4471,413,0.09237,2030,92067
1805,51,Multifamily,61,10,0.16393,2030,92067
1806,0,Mobile Home,0,0,,2030,92067
1807,4109,Total Units,4532,423,0.09334,2030,92067
1808,4531,Single Family - Detached,4919,388,0.07888,2035,92067
1809,52,Multifamily,61,9,0.14754,2035,92067
1810,0,Mobile Home,0,0,,2035,92067
1811,4583,Total Units,4980,397,0.07972,2035,92067
1812,4642,Single Family - Detached,5063,421,0.08315,2040,92067
1813,50,Multifamily,61,11,0.18033,2040,92067
1814,0,Mobile Home,0,0,,2040,92067
1815,4692,Total Units,5124,432,0.08431,2040,92067
1816,4710,Single Family - Detached,5162,452,0.08756,2045,92067
1817,50,Multifamily,62,12,0.19355,2045,92067
1818,0,Mobile Home,0,0,,2045,92067
1819,4760,Total Units,5224,464,0.08882,2045,92067
1820,4708,Single Family - Detached,5166,458,0.08866,2050,92067
1821,50,Multifamily,62,12,0.19355,2050,92067
1822,0,Mobile Home,0,0,,2050,92067
1823,4758,Total Units,5228,470,0.0899,2050,92067
1824,8491,Single Family - Detached,8678,187,0.02155,2012,92069
1825,4633,Multifamily,4772,139,0.02913,2012,92069
1826,1147,Mobile Home,1159,12,0.01035,2012,92069
1827,14271,Total Units,14609,338,0.02314,2012,92069
1828,8608,Single Family - Detached,8842,234,0.02646,2020,92069
1829,5476,Multifamily,5613,137,0.02441,2020,92069
1830,1151,Mobile Home,1159,8,0.0069,2020,92069
1831,15235,Total Units,15614,379,0.02427,2020,92069
1832,8828,Single Family - Detached,9010,182,0.0202,2025,92069
1833,5487,Multifamily,5633,146,0.02592,2025,92069
1834,1148,Mobile Home,1159,11,0.00949,2025,92069
1835,15463,Total Units,15802,339,0.02145,2025,92069
1836,8892,Single Family - Detached,9080,188,0.0207,2030,92069
1837,5495,Multifamily,5645,150,0.02657,2030,92069
1838,1137,Mobile Home,1159,22,0.01898,2030,92069
1839,15524,Total Units,15884,360,0.02266,2030,92069
1840,8952,Single Family - Detached,9129,177,0.01939,2035,92069
1841,5548,Multifamily,5674,126,0.02221,2035,92069
1842,1140,Mobile Home,1159,19,0.01639,2035,92069
1843,15640,Total Units,15962,322,0.02017,2035,92069
1844,9003,Single Family - Detached,9210,207,0.02248,2040,92069
1845,5682,Multifamily,5844,162,0.02772,2040,92069
1846,1075,Mobile Home,1078,3,0.00278,2040,92069
1847,15760,Total Units,16132,372,0.02306,2040,92069
1848,9021,Single Family - Detached,9263,242,0.02613,2045,92069
1849,5703,Multifamily,5871,168,0.02862,2045,92069
1850,1054,Mobile Home,1066,12,0.01126,2045,92069
1851,15778,Total Units,16200,422,0.02605,2045,92069
1852,9122,Single Family - Detached,9377,255,0.02719,2050,92069
1853,5538,Multifamily,5706,168,0.02944,2050,92069
1854,1025,Mobile Home,1066,41,0.03846,2050,92069
1855,15685,Total Units,16149,464,0.02873,2050,92069
1856,329,Single Family - Detached,352,23,0.06534,2012,92070
1857,0,Multifamily,0,0,,2012,92070
1858,28,Mobile Home,68,40,0.58824,2012,92070
1859,357,Total Units,420,63,0.15,2012,92070
1860,335,Single Family - Detached,368,33,0.08967,2020,92070
1861,0,Multifamily,0,0,,2020,92070
1862,28,Mobile Home,68,40,0.58824,2020,92070
1863,363,Total Units,436,73,0.16743,2020,92070
1864,341,Single Family - Detached,368,27,0.07337,2025,92070
1865,0,Multifamily,0,0,,2025,92070
1866,28,Mobile Home,68,40,0.58824,2025,92070
1867,369,Total Units,436,67,0.15367,2025,92070
1868,360,Single Family - Detached,383,23,0.06005,2030,92070
1869,0,Multifamily,0,0,,2030,92070
1870,27,Mobile Home,68,41,0.60294,2030,92070
1871,387,Total Units,451,64,0.14191,2030,92070
1872,383,Single Family - Detached,408,25,0.06127,2035,92070
1873,0,Multifamily,0,0,,2035,92070
1874,27,Mobile Home,68,41,0.60294,2035,92070
1875,410,Total Units,476,66,0.13866,2035,92070
1876,381,Single Family - Detached,407,26,0.06388,2040,92070
1877,0,Multifamily,0,0,,2040,92070
1878,27,Mobile Home,68,41,0.60294,2040,92070
1879,408,Total Units,475,67,0.14105,2040,92070
1880,377,Single Family - Detached,407,30,0.07371,2045,92070
1881,0,Multifamily,0,0,,2045,92070
1882,26,Mobile Home,68,42,0.61765,2045,92070
1883,403,Total Units,475,72,0.15158,2045,92070
1884,374,Single Family - Detached,407,33,0.08108,2050,92070
1885,0,Multifamily,0,0,,2050,92070
1886,25,Mobile Home,68,43,0.63235,2050,92070
1887,399,Total Units,475,76,0.16,2050,92070
1888,12438,Single Family - Detached,12687,249,0.01963,2012,92071
1889,4999,Multifamily,5140,141,0.02743,2012,92071
1890,2175,Mobile Home,2233,58,0.02597,2012,92071
1891,19612,Total Units,20060,448,0.02233,2012,92071
1892,13091,Single Family - Detached,13382,291,0.02175,2020,92071
1893,5657,Multifamily,5792,135,0.02331,2020,92071
1894,2197,Mobile Home,2252,55,0.02442,2020,92071
1895,20945,Total Units,21426,481,0.02245,2020,92071
1896,13411,Single Family - Detached,13637,226,0.01657,2025,92071
1897,6049,Multifamily,6177,128,0.02072,2025,92071
1898,2195,Mobile Home,2252,57,0.02531,2025,92071
1899,21655,Total Units,22066,411,0.01863,2025,92071
1900,13572,Single Family - Detached,13803,231,0.01674,2030,92071
1901,6242,Multifamily,6376,134,0.02102,2030,92071
1902,2183,Mobile Home,2252,69,0.03064,2030,92071
1903,21997,Total Units,22431,434,0.01935,2030,92071
1904,13681,Single Family - Detached,13889,208,0.01498,2035,92071
1905,6373,Multifamily,6504,131,0.02014,2035,92071
1906,2185,Mobile Home,2252,67,0.02975,2035,92071
1907,22239,Total Units,22645,406,0.01793,2035,92071
1908,13873,Single Family - Detached,14117,244,0.01728,2040,92071
1909,6895,Multifamily,7062,167,0.02365,2040,92071
1910,2190,Mobile Home,2252,62,0.02753,2040,92071
1911,22958,Total Units,23431,473,0.02019,2040,92071
1912,13971,Single Family - Detached,14240,269,0.01889,2045,92071
1913,7042,Multifamily,7225,183,0.02533,2045,92071
1914,2180,Mobile Home,2252,72,0.03197,2045,92071
1915,23193,Total Units,23717,524,0.02209,2045,92071
1916,13980,Single Family - Detached,14255,275,0.01929,2050,92071
1917,7040,Multifamily,7225,185,0.02561,2050,92071
1918,2141,Mobile Home,2252,111,0.04929,2050,92071
1919,23161,Total Units,23732,571,0.02406,2050,92071
1920,3251,Single Family - Detached,3470,219,0.06311,2012,92075
1921,1977,Multifamily,2598,621,0.23903,2012,92075
1922,16,Mobile Home,26,10,0.38462,2012,92075
1923,5244,Total Units,6094,850,0.13948,2012,92075
1924,3235,Single Family - Detached,3469,234,0.06745,2020,92075
1925,2026,Multifamily,2686,660,0.24572,2020,92075
1926,0,Mobile Home,0,0,,2020,92075
1927,5261,Total Units,6155,894,0.14525,2020,92075
1928,3252,Single Family - Detached,3469,217,0.06255,2025,92075
1929,2139,Multifamily,2739,600,0.21906,2025,92075
1930,0,Mobile Home,0,0,,2025,92075
1931,5391,Total Units,6208,817,0.1316,2025,92075
1932,3241,Single Family - Detached,3462,221,0.06384,2030,92075
1933,2227,Multifamily,2864,637,0.22242,2030,92075
1934,0,Mobile Home,0,0,,2030,92075
1935,5468,Total Units,6326,858,0.13563,2030,92075
1936,3275,Single Family - Detached,3482,207,0.05945,2035,92075
1937,2289,Multifamily,2910,621,0.2134,2035,92075
1938,0,Mobile Home,0,0,,2035,92075
1939,5564,Total Units,6392,828,0.12954,2035,92075
1940,3271,Single Family - Detached,3482,211,0.0606,2040,92075
1941,2533,Multifamily,3070,537,0.17492,2040,92075
1942,0,Mobile Home,0,0,,2040,92075
1943,5804,Total Units,6552,748,0.11416,2040,92075
1944,3248,Single Family - Detached,3473,225,0.06479,2045,92075
1945,2599,Multifamily,3184,585,0.18373,2045,92075
1946,0,Mobile Home,0,0,,2045,92075
1947,5847,Total Units,6657,810,0.12168,2045,92075
1948,3247,Single Family - Detached,3473,226,0.06507,2050,92075
1949,2606,Multifamily,3207,601,0.1874,2050,92075
1950,0,Mobile Home,0,0,,2050,92075
1951,5853,Total Units,6680,827,0.1238,2050,92075
1952,8197,Single Family - Detached,8672,475,0.05477,2012,92078
1953,4908,Multifamily,5002,94,0.01879,2012,92078
1954,2309,Mobile Home,2513,204,0.08118,2012,92078
1955,15414,Total Units,16187,773,0.04775,2012,92078
1956,9154,Single Family - Detached,9700,546,0.05629,2020,92078
1957,6741,Multifamily,6912,171,0.02474,2020,92078
1958,2316,Mobile Home,2513,197,0.07839,2020,92078
1959,18211,Total Units,19125,914,0.04779,2020,92078
1960,9399,Single Family - Detached,9855,456,0.04627,2025,92078
1961,9413,Multifamily,9613,200,0.02081,2025,92078
1962,2314,Mobile Home,2513,199,0.07919,2025,92078
1963,21126,Total Units,21981,855,0.0389,2025,92078
1964,9386,Single Family - Detached,9846,460,0.04672,2030,92078
1965,9645,Multifamily,9846,201,0.02041,2030,92078
1966,2303,Mobile Home,2513,210,0.08357,2030,92078
1967,21334,Total Units,22205,871,0.03923,2030,92078
1968,9440,Single Family - Detached,9861,421,0.04269,2035,92078
1969,10209,Multifamily,10414,205,0.01969,2035,92078
1970,2305,Mobile Home,2513,208,0.08277,2035,92078
1971,21954,Total Units,22788,834,0.0366,2035,92078
1972,9524,Single Family - Detached,9899,375,0.03788,2040,92078
1973,11668,Multifamily,11761,93,0.00791,2040,92078
1974,2316,Mobile Home,2513,197,0.07839,2040,92078
1975,23508,Total Units,24173,665,0.02751,2040,92078
1976,9511,Single Family - Detached,9922,411,0.04142,2045,92078
1977,11654,Multifamily,11765,111,0.00943,2045,92078
1978,2302,Mobile Home,2513,211,0.08396,2045,92078
1979,23467,Total Units,24200,733,0.03029,2045,92078
1980,9573,Single Family - Detached,9999,426,0.0426,2050,92078
1981,11646,Multifamily,11765,119,0.01011,2050,92078
1982,2262,Mobile Home,2513,251,0.09988,2050,92078
1983,23481,Total Units,24277,796,0.03279,2050,92078
1984,5996,Single Family - Detached,6291,295,0.04689,2012,92081
1985,3880,Multifamily,4113,233,0.05665,2012,92081
1986,510,Mobile Home,536,26,0.04851,2012,92081
1987,10386,Total Units,10940,554,0.05064,2012,92081
1988,6132,Single Family - Detached,6445,313,0.04856,2020,92081
1989,3884,Multifamily,4114,230,0.05591,2020,92081
1990,512,Mobile Home,536,24,0.04478,2020,92081
1991,10528,Total Units,11095,567,0.0511,2020,92081
1992,6419,Single Family - Detached,6666,247,0.03705,2025,92081
1993,3928,Multifamily,4149,221,0.05327,2025,92081
1994,511,Mobile Home,536,25,0.04664,2025,92081
1995,10858,Total Units,11351,493,0.04343,2025,92081
1996,6534,Single Family - Detached,6798,264,0.03883,2030,92081
1997,3930,Multifamily,4151,221,0.05324,2030,92081
1998,507,Mobile Home,536,29,0.0541,2030,92081
1999,10971,Total Units,11485,514,0.04475,2030,92081
2000,6668,Single Family - Detached,6906,238,0.03446,2035,92081
2001,4008,Multifamily,4173,165,0.03954,2035,92081
2002,509,Mobile Home,536,27,0.05037,2035,92081
2003,11185,Total Units,11615,430,0.03702,2035,92081
2004,6756,Single Family - Detached,7032,276,0.03925,2040,92081
2005,4036,Multifamily,4205,169,0.04019,2040,92081
2006,510,Mobile Home,536,26,0.04851,2040,92081
2007,11302,Total Units,11773,471,0.04001,2040,92081
2008,6744,Single Family - Detached,7038,294,0.04177,2045,92081
2009,4030,Multifamily,4205,175,0.04162,2045,92081
2010,507,Mobile Home,536,29,0.0541,2045,92081
2011,11281,Total Units,11779,498,0.04228,2045,92081
2012,6753,Single Family - Detached,7056,303,0.04294,2050,92081
2013,4029,Multifamily,4205,176,0.04185,2050,92081
2014,496,Mobile Home,536,40,0.07463,2050,92081
2015,11278,Total Units,11797,519,0.04399,2050,92081
2016,5626,Single Family - Detached,5682,56,0.00986,2012,92082
2017,20,Multifamily,31,11,0.35484,2012,92082
2018,474,Mobile Home,478,4,0.00837,2012,92082
2019,6120,Total Units,6191,71,0.01147,2012,92082
2020,6700,Single Family - Detached,6818,118,0.01731,2020,92082
2021,28,Multifamily,31,3,0.09677,2020,92082
2022,456,Mobile Home,459,3,0.00654,2020,92082
2023,7184,Total Units,7308,124,0.01697,2020,92082
2024,6953,Single Family - Detached,7041,88,0.0125,2025,92082
2025,29,Multifamily,31,2,0.06452,2025,92082
2026,456,Mobile Home,459,3,0.00654,2025,92082
2027,7438,Total Units,7531,93,0.01235,2025,92082
2028,7217,Single Family - Detached,7311,94,0.01286,2030,92082
2029,27,Multifamily,31,4,0.12903,2030,92082
2030,452,Mobile Home,459,7,0.01525,2030,92082
2031,7696,Total Units,7801,105,0.01346,2030,92082
2032,7591,Single Family - Detached,7677,86,0.0112,2035,92082
2033,30,Multifamily,31,1,0.03226,2035,92082
2034,452,Mobile Home,459,7,0.01525,2035,92082
2035,8073,Total Units,8167,94,0.01151,2035,92082
2036,7692,Single Family - Detached,7793,101,0.01296,2040,92082
2037,125,Multifamily,128,3,0.02344,2040,92082
2038,454,Mobile Home,459,5,0.01089,2040,92082
2039,8271,Total Units,8380,109,0.01301,2040,92082
2040,7781,Single Family - Detached,7896,115,0.01456,2045,92082
2041,620,Multifamily,623,3,0.00482,2045,92082
2042,452,Mobile Home,459,7,0.01525,2045,92082
2043,8853,Total Units,8978,125,0.01392,2045,92082
2044,7787,Single Family - Detached,7903,116,0.01468,2050,92082
2045,620,Multifamily,623,3,0.00482,2050,92082
2046,441,Mobile Home,459,18,0.03922,2050,92082
2047,8848,Total Units,8985,137,0.01525,2050,92082
2048,5563,Single Family - Detached,5699,136,0.02386,2012,92083
2049,4119,Multifamily,4384,265,0.06045,2012,92083
2050,792,Mobile Home,832,40,0.04808,2012,92083
2051,10474,Total Units,10915,441,0.0404,2012,92083
2052,5816,Single Family - Detached,5971,155,0.02596,2020,92083
2053,4145,Multifamily,4381,236,0.05387,2020,92083
2054,755,Mobile Home,804,49,0.06095,2020,92083
2055,10716,Total Units,11156,440,0.03944,2020,92083
2056,6083,Single Family - Detached,6208,125,0.02014,2025,92083
2057,5530,Multifamily,5745,215,0.03742,2025,92083
2058,723,Mobile Home,773,50,0.06468,2025,92083
2059,12336,Total Units,12726,390,0.03065,2025,92083
2060,6174,Single Family - Detached,6316,142,0.02248,2030,92083
2061,6178,Multifamily,6407,229,0.03574,2030,92083
2062,718,Mobile Home,773,55,0.07115,2030,92083
2063,13070,Total Units,13496,426,0.03156,2030,92083
2064,6245,Single Family - Detached,6388,143,0.02239,2035,92083
2065,6848,Multifamily,7122,274,0.03847,2035,92083
2066,718,Mobile Home,773,55,0.07115,2035,92083
2067,13811,Total Units,14283,472,0.03305,2035,92083
2068,6319,Single Family - Detached,6472,153,0.02364,2040,92083
2069,7777,Multifamily,8083,306,0.03786,2040,92083
2070,721,Mobile Home,773,52,0.06727,2040,92083
2071,14817,Total Units,15328,511,0.03334,2040,92083
2072,6308,Single Family - Detached,6471,163,0.02519,2045,92083
2073,9217,Multifamily,9599,382,0.0398,2045,92083
2074,717,Mobile Home,773,56,0.07245,2045,92083
2075,16242,Total Units,16843,601,0.03568,2045,92083
2076,6301,Single Family - Detached,6471,170,0.02627,2050,92083
2077,9272,Multifamily,9685,413,0.04264,2050,92083
2078,702,Mobile Home,773,71,0.09185,2050,92083
2079,16275,Total Units,16929,654,0.03863,2050,92083
2080,10587,Single Family - Detached,10847,260,0.02397,2012,92084
2081,3595,Multifamily,3709,114,0.03074,2012,92084
2082,738,Mobile Home,886,148,0.16704,2012,92084
2083,14920,Total Units,15442,522,0.0338,2012,92084
2084,10913,Single Family - Detached,11200,287,0.02563,2020,92084
2085,3561,Multifamily,3705,144,0.03887,2020,92084
2086,679,Mobile Home,802,123,0.15337,2020,92084
2087,15153,Total Units,15707,554,0.03527,2020,92084
2088,11278,Single Family - Detached,11523,245,0.02126,2025,92084
2089,3877,Multifamily,4044,167,0.0413,2025,92084
2090,679,Mobile Home,802,123,0.15337,2025,92084
2091,15834,Total Units,16369,535,0.03268,2025,92084
2092,11781,Single Family - Detached,12034,253,0.02102,2030,92084
2093,4171,Multifamily,4387,216,0.04924,2030,92084
2094,677,Mobile Home,802,125,0.15586,2030,92084
2095,16629,Total Units,17223,594,0.03449,2030,92084
2096,11992,Single Family - Detached,12228,236,0.0193,2035,92084
2097,4664,Multifamily,4918,254,0.05165,2035,92084
2098,678,Mobile Home,802,124,0.15461,2035,92084
2099,17334,Total Units,17948,614,0.03421,2035,92084
2100,12127,Single Family - Detached,12397,270,0.02178,2040,92084
2101,5371,Multifamily,5726,355,0.062,2040,92084
2102,678,Mobile Home,802,124,0.15461,2040,92084
2103,18176,Total Units,18925,749,0.03958,2040,92084
2104,12170,Single Family - Detached,12472,302,0.02421,2045,92084
2105,6104,Multifamily,6541,437,0.06681,2045,92084
2106,676,Mobile Home,802,126,0.15711,2045,92084
2107,18950,Total Units,19815,865,0.04365,2045,92084
2108,12221,Single Family - Detached,12530,309,0.02466,2050,92084
2109,6931,Multifamily,7406,475,0.06414,2050,92084
2110,665,Mobile Home,802,137,0.17082,2050,92084
2111,19817,Total Units,20738,921,0.04441,2050,92084
2112,219,Single Family - Detached,228,9,0.03947,2012,92086
2113,0,Multifamily,0,0,,2012,92086
2114,259,Mobile Home,346,87,0.25145,2012,92086
2115,478,Total Units,574,96,0.16725,2012,92086
2116,242,Single Family - Detached,252,10,0.03968,2020,92086
2117,0,Multifamily,0,0,,2020,92086
2118,261,Mobile Home,346,85,0.24566,2020,92086
2119,503,Total Units,598,95,0.15886,2020,92086
2120,249,Single Family - Detached,256,7,0.02734,2025,92086
2121,0,Multifamily,0,0,,2025,92086
2122,260,Mobile Home,346,86,0.24855,2025,92086
2123,509,Total Units,602,93,0.15449,2025,92086
2124,253,Single Family - Detached,260,7,0.02692,2030,92086
2125,0,Multifamily,0,0,,2030,92086
2126,259,Mobile Home,346,87,0.25145,2030,92086
2127,512,Total Units,606,94,0.15512,2030,92086
2128,293,Single Family - Detached,298,5,0.01678,2035,92086
2129,0,Multifamily,0,0,,2035,92086
2130,260,Mobile Home,346,86,0.24855,2035,92086
2131,553,Total Units,644,91,0.1413,2035,92086
2132,293,Single Family - Detached,298,5,0.01678,2040,92086
2133,0,Multifamily,0,0,,2040,92086
2134,260,Mobile Home,346,86,0.24855,2040,92086
2135,553,Total Units,644,91,0.1413,2040,92086
2136,293,Single Family - Detached,299,6,0.02007,2045,92086
2137,0,Multifamily,0,0,,2045,92086
2138,259,Mobile Home,346,87,0.25145,2045,92086
2139,552,Total Units,645,93,0.14419,2045,92086
2140,296,Single Family - Detached,301,5,0.01661,2050,92086
2141,0,Multifamily,0,0,,2050,92086
2142,254,Mobile Home,346,92,0.2659,2050,92086
2143,550,Total Units,647,97,0.14992,2050,92086
2144,609,Single Family - Detached,735,126,0.17143,2012,92091
2145,84,Multifamily,58,-26,-0.44828,2012,92091
2146,0,Mobile Home,0,0,,2012,92091
2147,693,Total Units,793,100,0.1261,2012,92091
2148,609,Single Family - Detached,735,126,0.17143,2020,92091
2149,84,Multifamily,58,-26,-0.44828,2020,92091
2150,0,Mobile Home,0,0,,2020,92091
2151,693,Total Units,793,100,0.1261,2020,92091
2152,709,Single Family - Detached,832,123,0.14784,2025,92091
2153,84,Multifamily,58,-26,-0.44828,2025,92091
2154,0,Mobile Home,0,0,,2025,92091
2155,793,Total Units,890,97,0.10899,2025,92091
2156,709,Single Family - Detached,832,123,0.14784,2030,92091
2157,84,Multifamily,58,-26,-0.44828,2030,92091
2158,0,Mobile Home,0,0,,2030,92091
2159,793,Total Units,890,97,0.10899,2030,92091
2160,713,Single Family - Detached,840,127,0.15119,2035,92091
2161,84,Multifamily,58,-26,-0.44828,2035,92091
2162,0,Mobile Home,0,0,,2035,92091
2163,797,Total Units,898,101,0.11247,2035,92091
2164,727,Single Family - Detached,841,114,0.13555,2040,92091
2165,83,Multifamily,58,-25,-0.43103,2040,92091
2166,0,Mobile Home,0,0,,2040,92091
2167,810,Total Units,899,89,0.099,2040,92091
2168,724,Single Family - Detached,841,117,0.13912,2045,92091
2169,82,Multifamily,58,-24,-0.41379,2045,92091
2170,0,Mobile Home,0,0,,2045,92091
2171,806,Total Units,899,93,0.10345,2045,92091
2172,722,Single Family - Detached,841,119,0.1415,2050,92091
2173,81,Multifamily,58,-23,-0.39655,2050,92091
2174,0,Mobile Home,0,0,,2050,92091
2175,803,Total Units,899,96,0.10679,2050,92091
2176,0,Single Family - Detached,0,0,,2012,92093
2177,106,Multifamily,106,0,0.0,2012,92093
2178,0,Mobile Home,0,0,,2012,92093
2179,106,Total Units,106,0,0.0,2012,92093
2180,0,Single Family - Detached,0,0,,2020,92093
2181,105,Multifamily,106,1,0.00943,2020,92093
2182,0,Mobile Home,0,0,,2020,92093
2183,105,Total Units,106,1,0.00943,2020,92093
2184,0,Single Family - Detached,0,0,,2025,92093
2185,105,Multifamily,107,2,0.01869,2025,92093
2186,0,Mobile Home,0,0,,2025,92093
2187,105,Total Units,107,2,0.01869,2025,92093
2188,0,Single Family - Detached,0,0,,2030,92093
2189,96,Multifamily,108,12,0.11111,2030,92093
2190,0,Mobile Home,0,0,,2030,92093
2191,96,Total Units,108,12,0.11111,2030,92093
2192,0,Single Family - Detached,0,0,,2035,92093
2193,96,Multifamily,108,12,0.11111,2035,92093
2194,0,Mobile Home,0,0,,2035,92093
2195,96,Total Units,108,12,0.11111,2035,92093
2196,0,Single Family - Detached,0,0,,2040,92093
2197,93,Multifamily,108,15,0.13889,2040,92093
2198,0,Mobile Home,0,0,,2040,92093
2199,93,Total Units,108,15,0.13889,2040,92093
2200,0,Single Family - Detached,0,0,,2045,92093
2201,93,Multifamily,108,15,0.13889,2045,92093
2202,0,Mobile Home,0,0,,2045,92093
2203,93,Total Units,108,15,0.13889,2045,92093
2204,0,Single Family - Detached,0,0,,2050,92093
2205,93,Multifamily,108,15,0.13889,2050,92093
2206,0,Mobile Home,0,0,,2050,92093
2207,93,Total Units,108,15,0.13889,2050,92093
2208,0,Single Family - Detached,0,0,,2012,92096
2209,0,Multifamily,0,0,,2012,92096
2210,0,Mobile Home,0,0,,2012,92096
2211,0,Total Units,0,0,,2012,92096
2212,0,Single Family - Detached,0,0,,2020,92096
2213,0,Multifamily,0,0,,2020,92096
2214,0,Mobile Home,0,0,,2020,92096
2215,0,Total Units,0,0,,2020,92096
2216,0,Single Family - Detached,0,0,,2025,92096
2217,0,Multifamily,0,0,,2025,92096
2218,0,Mobile Home,0,0,,2025,92096
2219,0,Total Units,0,0,,2025,92096
2220,0,Single Family - Detached,0,0,,2030,92096
2221,0,Multifamily,0,0,,2030,92096
2222,0,Mobile Home,0,0,,2030,92096
2223,0,Total Units,0,0,,2030,92096
2224,0,Single Family - Detached,0,0,,2035,92096
2225,0,Multifamily,0,0,,2035,92096
2226,0,Mobile Home,0,0,,2035,92096
2227,0,Total Units,0,0,,2035,92096
2228,0,Single Family - Detached,0,0,,2040,92096
2229,0,Multifamily,0,0,,2040,92096
2230,0,Mobile Home,0,0,,2040,92096
2231,0,Total Units,0,0,,2040,92096
2232,0,Single Family - Detached,0,0,,2045,92096
2233,0,Multifamily,0,0,,2045,92096
2234,0,Mobile Home,0,0,,2045,92096
2235,0,Total Units,0,0,,2045,92096
2236,0,Single Family - Detached,0,0,,2050,92096
2237,0,Multifamily,0,0,,2050,92096
2238,0,Mobile Home,0,0,,2050,92096
2239,0,Total Units,0,0,,2050,92096
2240,475,Single Family - Detached,524,49,0.09351,2012,92101
2241,20354,Multifamily,26746,6392,0.23899,2012,92101
2242,0,Mobile Home,0,0,,2012,92101
2243,20829,Total Units,27270,6441,0.23619,2012,92101
2244,464,Single Family - Detached,514,50,0.09728,2020,92101
2245,22792,Multifamily,30476,7684,0.25213,2020,92101
2246,0,Mobile Home,0,0,,2020,92101
2247,23256,Total Units,30990,7734,0.24956,2020,92101
2248,475,Single Family - Detached,511,36,0.07045,2025,92101
2249,27260,Multifamily,35214,7954,0.22588,2025,92101
2250,0,Mobile Home,0,0,,2025,92101
2251,27735,Total Units,35725,7990,0.22365,2025,92101
2252,459,Single Family - Detached,502,43,0.08566,2030,92101
2253,29500,Multifamily,38236,8736,0.22848,2030,92101
2254,0,Mobile Home,0,0,,2030,92101
2255,29959,Total Units,38738,8779,0.22663,2030,92101
2256,408,Single Family - Detached,440,32,0.07273,2035,92101
2257,34311,Multifamily,43853,9542,0.21759,2035,92101
2258,0,Mobile Home,0,0,,2035,92101
2259,34719,Total Units,44293,9574,0.21615,2035,92101
2260,342,Single Family - Detached,373,31,0.08311,2040,92101
2261,35732,Multifamily,46080,10348,0.22457,2040,92101
2262,0,Mobile Home,0,0,,2040,92101
2263,36074,Total Units,46453,10379,0.22343,2040,92101
2264,269,Single Family - Detached,298,29,0.09732,2045,92101
2265,37518,Multifamily,48978,11460,0.23398,2045,92101
2266,0,Mobile Home,0,0,,2045,92101
2267,37787,Total Units,49276,11489,0.23316,2045,92101
2268,217,Single Family - Detached,242,25,0.10331,2050,92101
2269,39389,Multifamily,51613,12224,0.23684,2050,92101
2270,0,Mobile Home,0,0,,2050,92101
2271,39606,Total Units,51855,12249,0.23622,2050,92101
2272,7973,Single Family - Detached,8401,428,0.05095,2012,92102
2273,5498,Multifamily,5858,360,0.06145,2012,92102
2274,428,Mobile Home,454,26,0.05727,2012,92102
2275,13899,Total Units,14713,814,0.05533,2012,92102
2276,8149,Single Family - Detached,8603,454,0.05277,2020,92102
2277,6381,Multifamily,6784,403,0.0594,2020,92102
2278,411,Mobile Home,436,25,0.05734,2020,92102
2279,14941,Total Units,15823,882,0.05574,2020,92102
2280,8115,Single Family - Detached,8479,364,0.04293,2025,92102
2281,7169,Multifamily,7550,381,0.05046,2025,92102
2282,309,Mobile Home,334,25,0.07485,2025,92102
2283,15593,Total Units,16363,770,0.04706,2025,92102
2284,7903,Single Family - Detached,8203,300,0.03657,2030,92102
2285,9243,Multifamily,9663,420,0.04346,2030,92102
2286,190,Mobile Home,211,21,0.09953,2030,92102
2287,17336,Total Units,18077,741,0.04099,2030,92102
2288,7696,Single Family - Detached,7974,278,0.03486,2035,92102
2289,10413,Multifamily,10853,440,0.04054,2035,92102
2290,0,Mobile Home,0,0,,2035,92102
2291,18109,Total Units,18827,718,0.03814,2035,92102
2292,7642,Single Family - Detached,7928,286,0.03607,2040,92102
2293,11336,Multifamily,11851,515,0.04346,2040,92102
2294,0,Mobile Home,0,0,,2040,92102
2295,18978,Total Units,19779,801,0.0405,2040,92102
2296,7577,Single Family - Detached,7908,331,0.04186,2045,92102
2297,11389,Multifamily,11952,563,0.04711,2045,92102
2298,0,Mobile Home,0,0,,2045,92102
2299,18966,Total Units,19860,894,0.04502,2045,92102
2300,7547,Single Family - Detached,7892,345,0.04372,2050,92102
2301,11425,Multifamily,12046,621,0.05155,2050,92102
2302,0,Mobile Home,0,0,,2050,92102
2303,18972,Total Units,19938,966,0.04845,2050,92102
2304,5997,Single Family - Detached,6318,321,0.05081,2012,92103
2305,11654,Multifamily,12412,758,0.06107,2012,92103
2306,0,Mobile Home,0,0,,2012,92103
2307,17651,Total Units,18730,1079,0.05761,2012,92103
2308,6056,Single Family - Detached,6391,335,0.05242,2020,92103
2309,11864,Multifamily,12672,808,0.06376,2020,92103
2310,0,Mobile Home,0,0,,2020,92103
2311,17920,Total Units,19063,1143,0.05996,2020,92103
2312,5934,Single Family - Detached,6194,260,0.04198,2025,92103
2313,14305,Multifamily,15113,808,0.05346,2025,92103
2314,0,Mobile Home,0,0,,2025,92103
2315,20239,Total Units,21307,1068,0.05012,2025,92103
2316,5781,Single Family - Detached,6027,246,0.04082,2030,92103
2317,15933,Multifamily,16862,929,0.05509,2030,92103
2318,0,Mobile Home,0,0,,2030,92103
2319,21714,Total Units,22889,1175,0.05133,2030,92103
2320,5669,Single Family - Detached,5892,223,0.03785,2035,92103
2321,17137,Multifamily,18106,969,0.05352,2035,92103
2322,0,Mobile Home,0,0,,2035,92103
2323,22806,Total Units,23998,1192,0.04967,2035,92103
2324,5455,Single Family - Detached,5682,227,0.03995,2040,92103
2325,18356,Multifamily,19501,1145,0.05871,2040,92103
2326,0,Mobile Home,0,0,,2040,92103
2327,23811,Total Units,25183,1372,0.05448,2040,92103
2328,5243,Single Family - Detached,5475,232,0.04237,2045,92103
2329,19815,Multifamily,21154,1339,0.0633,2045,92103
2330,0,Mobile Home,0,0,,2045,92103
2331,25058,Total Units,26629,1571,0.059,2045,92103
2332,5105,Single Family - Detached,5333,228,0.04275,2050,92103
2333,21043,Multifamily,22600,1557,0.06889,2050,92103
2334,0,Mobile Home,0,0,,2050,92103
2335,26148,Total Units,27933,1785,0.0639,2050,92103
2336,9433,Single Family - Detached,9841,408,0.04146,2012,92104
2337,12200,Multifamily,12750,550,0.04314,2012,92104
2338,0,Mobile Home,0,0,,2012,92104
2339,21633,Total Units,22591,958,0.04241,2012,92104
2340,9246,Single Family - Detached,9701,455,0.0469,2020,92104
2341,13303,Multifamily,13852,549,0.03963,2020,92104
2342,0,Mobile Home,0,0,,2020,92104
2343,22549,Total Units,23553,1004,0.04263,2020,92104
2344,9306,Single Family - Detached,9670,364,0.03764,2025,92104
2345,13403,Multifamily,13923,520,0.03735,2025,92104
2346,0,Mobile Home,0,0,,2025,92104
2347,22709,Total Units,23593,884,0.03747,2025,92104
2348,9077,Single Family - Detached,9435,358,0.03794,2030,92104
2349,14095,Multifamily,14683,588,0.04005,2030,92104
2350,0,Mobile Home,0,0,,2030,92104
2351,23172,Total Units,24118,946,0.03922,2030,92104
2352,8900,Single Family - Detached,9224,324,0.03513,2035,92104
2353,14841,Multifamily,15429,588,0.03811,2035,92104
2354,0,Mobile Home,0,0,,2035,92104
2355,23741,Total Units,24653,912,0.03699,2035,92104
2356,8638,Single Family - Detached,8985,347,0.03862,2040,92104
2357,16117,Multifamily,16802,685,0.04077,2040,92104
2358,0,Mobile Home,0,0,,2040,92104
2359,24755,Total Units,25787,1032,0.04002,2040,92104
2360,8222,Single Family - Detached,8595,373,0.0434,2045,92104
2361,17489,Multifamily,18249,760,0.04165,2045,92104
2362,0,Mobile Home,0,0,,2045,92104
2363,25711,Total Units,26844,1133,0.04221,2045,92104
2364,7570,Single Family - Detached,7928,358,0.04516,2050,92104
2365,20782,Multifamily,21619,837,0.03872,2050,92104
2366,0,Mobile Home,0,0,,2050,92104
2367,28352,Total Units,29547,1195,0.04044,2050,92104
2368,11000,Single Family - Detached,11581,581,0.05017,2012,92105
2369,9790,Multifamily,10198,408,0.04001,2012,92105
2370,252,Mobile Home,252,0,0.0,2012,92105
2371,21042,Total Units,22031,989,0.04489,2012,92105
2372,11134,Single Family - Detached,11741,607,0.0517,2020,92105
2373,9921,Multifamily,10386,465,0.04477,2020,92105
2374,252,Mobile Home,252,0,0.0,2020,92105
2375,21307,Total Units,22379,1072,0.0479,2020,92105
2376,11295,Single Family - Detached,11761,466,0.03962,2025,92105
2377,10214,Multifamily,10610,396,0.03732,2025,92105
2378,252,Mobile Home,252,0,0.0,2025,92105
2379,21761,Total Units,22623,862,0.0381,2025,92105
2380,11122,Single Family - Detached,11596,474,0.04088,2030,92105
2381,11816,Multifamily,12294,478,0.03888,2030,92105
2382,251,Mobile Home,252,1,0.00397,2030,92105
2383,23189,Total Units,24142,953,0.03947,2030,92105
2384,10882,Single Family - Detached,11312,430,0.03801,2035,92105
2385,13733,Multifamily,14250,517,0.03628,2035,92105
2386,251,Mobile Home,252,1,0.00397,2035,92105
2387,24866,Total Units,25814,948,0.03672,2035,92105
2388,10451,Single Family - Detached,10888,437,0.04014,2040,92105
2389,15185,Multifamily,15769,584,0.03703,2040,92105
2390,252,Mobile Home,252,0,0.0,2040,92105
2391,25888,Total Units,26909,1021,0.03794,2040,92105
2392,10112,Single Family - Detached,10561,449,0.04251,2045,92105
2393,16851,Multifamily,17528,677,0.03862,2045,92105
2394,251,Mobile Home,252,1,0.00397,2045,92105
2395,27214,Total Units,28341,1127,0.03977,2045,92105
2396,9752,Single Family - Detached,10189,437,0.04289,2050,92105
2397,18252,Multifamily,19051,799,0.04194,2050,92105
2398,246,Mobile Home,252,6,0.02381,2050,92105
2399,28250,Total Units,29492,1242,0.04211,2050,92105
2400,5952,Single Family - Detached,6168,216,0.03502,2012,92106
2401,2257,Multifamily,2445,188,0.07689,2012,92106
2402,0,Mobile Home,0,0,,2012,92106
2403,8209,Total Units,8613,404,0.04691,2012,92106
2404,5920,Single Family - Detached,6167,247,0.04005,2020,92106
2405,2286,Multifamily,2476,190,0.07674,2020,92106
2406,0,Mobile Home,0,0,,2020,92106
2407,8206,Total Units,8643,437,0.05056,2020,92106
2408,5858,Single Family - Detached,6082,224,0.03683,2025,92106
2409,2748,Multifamily,2942,194,0.06594,2025,92106
2410,0,Mobile Home,0,0,,2025,92106
2411,8606,Total Units,9024,418,0.04632,2025,92106
2412,5772,Single Family - Detached,6023,251,0.04167,2030,92106
2413,3134,Multifamily,3340,206,0.06168,2030,92106
2414,0,Mobile Home,0,0,,2030,92106
2415,8906,Total Units,9363,457,0.04881,2030,92106
2416,5678,Single Family - Detached,5919,241,0.04072,2035,92106
2417,3736,Multifamily,3957,221,0.05585,2035,92106
2418,0,Mobile Home,0,0,,2035,92106
2419,9414,Total Units,9876,462,0.04678,2035,92106
2420,5577,Single Family - Detached,5832,255,0.04372,2040,92106
2421,4296,Multifamily,4560,264,0.05789,2040,92106
2422,0,Mobile Home,0,0,,2040,92106
2423,9873,Total Units,10392,519,0.04994,2040,92106
2424,5555,Single Family - Detached,5835,280,0.04799,2045,92106
2425,4323,Multifamily,4612,289,0.06266,2045,92106
2426,0,Mobile Home,0,0,,2045,92106
2427,9878,Total Units,10447,569,0.05447,2045,92106
2428,5550,Single Family - Detached,5833,283,0.04852,2050,92106
2429,4350,Multifamily,4668,318,0.06812,2050,92106
2430,0,Mobile Home,0,0,,2050,92106
2431,9900,Total Units,10501,601,0.05723,2050,92106
2432,7770,Single Family - Detached,8031,261,0.0325,2012,92107
2433,5645,Multifamily,5935,290,0.04886,2012,92107
2434,0,Mobile Home,0,0,,2012,92107
2435,13415,Total Units,13966,551,0.03945,2012,92107
2436,7757,Single Family - Detached,8036,279,0.03472,2020,92107
2437,5674,Multifamily,5976,302,0.05054,2020,92107
2438,0,Mobile Home,0,0,,2020,92107
2439,13431,Total Units,14012,581,0.04146,2020,92107
2440,7787,Single Family - Detached,8011,224,0.02796,2025,92107
2441,5867,Multifamily,6137,270,0.044,2025,92107
2442,0,Mobile Home,0,0,,2025,92107
2443,13654,Total Units,14148,494,0.03492,2025,92107
2444,7653,Single Family - Detached,7896,243,0.03078,2030,92107
2445,6344,Multifamily,6692,348,0.052,2030,92107
2446,0,Mobile Home,0,0,,2030,92107
2447,13997,Total Units,14588,591,0.04051,2030,92107
2448,7608,Single Family - Detached,7827,219,0.02798,2035,92107
2449,6604,Multifamily,6947,343,0.04937,2035,92107
2450,0,Mobile Home,0,0,,2035,92107
2451,14212,Total Units,14774,562,0.03804,2035,92107
2452,7510,Single Family - Detached,7745,235,0.03034,2040,92107
2453,6939,Multifamily,7335,396,0.05399,2040,92107
2454,0,Mobile Home,0,0,,2040,92107
2455,14449,Total Units,15080,631,0.04184,2040,92107
2456,7350,Single Family - Detached,7594,244,0.03213,2045,92107
2457,7367,Multifamily,7804,437,0.056,2045,92107
2458,0,Mobile Home,0,0,,2045,92107
2459,14717,Total Units,15398,681,0.04423,2045,92107
2460,7123,Single Family - Detached,7366,243,0.03299,2050,92107
2461,8302,Multifamily,8819,517,0.05862,2050,92107
2462,0,Mobile Home,0,0,,2050,92107
2463,15425,Total Units,16185,760,0.04696,2050,92107
2464,1024,Single Family - Detached,1215,191,0.1572,2012,92108
2465,8690,Multifamily,9422,732,0.07769,2012,92108
2466,0,Mobile Home,0,0,,2012,92108
2467,9714,Total Units,10637,923,0.08677,2012,92108
2468,1210,Single Family - Detached,1465,255,0.17406,2020,92108
2469,11248,Multifamily,12263,1015,0.08277,2020,92108
2470,0,Mobile Home,0,0,,2020,92108
2471,12458,Total Units,13728,1270,0.09251,2020,92108
2472,1359,Single Family - Detached,1590,231,0.14528,2025,92108
2473,12456,Multifamily,13428,972,0.07239,2025,92108
2474,0,Mobile Home,0,0,,2025,92108
2475,13815,Total Units,15018,1203,0.0801,2025,92108
2476,1504,Single Family - Detached,1755,251,0.14302,2030,92108
2477,13947,Multifamily,15043,1096,0.07286,2030,92108
2478,0,Mobile Home,0,0,,2030,92108
2479,15451,Total Units,16798,1347,0.08019,2030,92108
2480,1531,Single Family - Detached,1765,234,0.13258,2035,92108
2481,15979,Multifamily,17172,1193,0.06947,2035,92108
2482,0,Mobile Home,0,0,,2035,92108
2483,17510,Total Units,18937,1427,0.07536,2035,92108
2484,1574,Single Family - Detached,1833,259,0.1413,2040,92108
2485,16558,Multifamily,17881,1323,0.07399,2040,92108
2486,0,Mobile Home,0,0,,2040,92108
2487,18132,Total Units,19714,1582,0.08025,2040,92108
2488,1566,Single Family - Detached,1850,284,0.15351,2045,92108
2489,17059,Multifamily,18510,1451,0.07839,2045,92108
2490,0,Mobile Home,0,0,,2045,92108
2491,18625,Total Units,20360,1735,0.08522,2045,92108
2492,1567,Single Family - Detached,1862,295,0.15843,2050,92108
2493,17048,Multifamily,18510,1462,0.07898,2050,92108
2494,0,Mobile Home,0,0,,2050,92108
2495,18615,Total Units,20372,1757,0.08625,2050,92108
2496,9451,Single Family - Detached,10280,829,0.08064,2012,92109
2497,13796,Multifamily,15259,1463,0.09588,2012,92109
2498,316,Mobile Home,352,36,0.10227,2012,92109
2499,23563,Total Units,25891,2328,0.08992,2012,92109
2500,8618,Single Family - Detached,9474,856,0.09035,2020,92109
2501,15312,Multifamily,17098,1786,0.10446,2020,92109
2502,287,Mobile Home,318,31,0.09748,2020,92109
2503,24217,Total Units,26890,2673,0.0994,2020,92109
2504,8722,Single Family - Detached,9408,686,0.07292,2025,92109
2505,15747,Multifamily,17377,1630,0.0938,2025,92109
2506,277,Mobile Home,306,29,0.09477,2025,92109
2507,24746,Total Units,27091,2345,0.08656,2025,92109
2508,8100,Single Family - Detached,8768,668,0.07619,2030,92109
2509,16802,Multifamily,18561,1759,0.09477,2030,92109
2510,265,Mobile Home,294,29,0.09864,2030,92109
2511,25167,Total Units,27623,2456,0.08891,2030,92109
2512,7196,Single Family - Detached,7775,579,0.07447,2035,92109
2513,19635,Multifamily,21509,1874,0.08713,2035,92109
2514,255,Mobile Home,279,24,0.08602,2035,92109
2515,27086,Total Units,29563,2477,0.08379,2035,92109
2516,6766,Single Family - Detached,7351,585,0.07958,2040,92109
2517,20758,Multifamily,22870,2112,0.09235,2040,92109
2518,223,Mobile Home,240,17,0.07083,2040,92109
2519,27747,Total Units,30461,2714,0.0891,2040,92109
2520,6493,Single Family - Detached,7110,617,0.08678,2045,92109
2521,22126,Multifamily,24485,2359,0.09634,2045,92109
2522,186,Mobile Home,199,13,0.06533,2045,92109
2523,28805,Total Units,31794,2989,0.09401,2045,92109
2524,6485,Single Family - Detached,7108,623,0.08765,2050,92109
2525,22192,Multifamily,24596,2404,0.09774,2050,92109
2526,146,Mobile Home,156,10,0.0641,2050,92109
2527,28823,Total Units,31860,3037,0.09532,2050,92109
2528,4614,Single Family - Detached,4766,152,0.03189,2012,92110
2529,6044,Multifamily,6599,555,0.0841,2012,92110
2530,175,Mobile Home,197,22,0.11168,2012,92110
2531,10833,Total Units,11562,729,0.06305,2012,92110
2532,4579,Single Family - Detached,4763,184,0.03863,2020,92110
2533,6669,Multifamily,7320,651,0.08893,2020,92110
2534,115,Mobile Home,129,14,0.10853,2020,92110
2535,11363,Total Units,12212,849,0.06952,2020,92110
2536,4626,Single Family - Detached,4765,139,0.02917,2025,92110
2537,7993,Multifamily,8655,662,0.07649,2025,92110
2538,80,Mobile Home,90,10,0.11111,2025,92110
2539,12699,Total Units,13510,811,0.06003,2025,92110
2540,4577,Single Family - Detached,4688,111,0.02368,2030,92110
2541,9025,Multifamily,9739,714,0.07331,2030,92110
2542,80,Mobile Home,90,10,0.11111,2030,92110
2543,13682,Total Units,14517,835,0.05752,2030,92110
2544,4431,Single Family - Detached,4544,113,0.02487,2035,92110
2545,10406,Multifamily,11106,700,0.06303,2035,92110
2546,80,Mobile Home,90,10,0.11111,2035,92110
2547,14917,Total Units,15740,823,0.05229,2035,92110
2548,4364,Single Family - Detached,4493,129,0.02871,2040,92110
2549,11840,Multifamily,12668,828,0.06536,2040,92110
2550,0,Mobile Home,0,0,,2040,92110
2551,16204,Total Units,17161,957,0.05577,2040,92110
2552,4338,Single Family - Detached,4503,165,0.03664,2045,92110
2553,13979,Multifamily,15001,1022,0.06813,2045,92110
2554,0,Mobile Home,0,0,,2045,92110
2555,18317,Total Units,19504,1187,0.06086,2045,92110
2556,4317,Single Family - Detached,4491,174,0.03874,2050,92110
2557,14898,Multifamily,15923,1025,0.06437,2050,92110
2558,0,Mobile Home,0,0,,2050,92110
2559,19215,Total Units,20414,1199,0.05873,2050,92110
2560,10170,Single Family - Detached,10479,309,0.02949,2012,92111
2561,7192,Multifamily,7557,365,0.0483,2012,92111
2562,220,Mobile Home,220,0,0.0,2012,92111
2563,17582,Total Units,18256,674,0.03692,2012,92111
2564,10431,Single Family - Detached,10775,344,0.03193,2020,92111
2565,7564,Multifamily,7921,357,0.04507,2020,92111
2566,220,Mobile Home,220,0,0.0,2020,92111
2567,18215,Total Units,18916,701,0.03706,2020,92111
2568,10713,Single Family - Detached,10981,268,0.02441,2025,92111
2569,7938,Multifamily,8258,320,0.03875,2025,92111
2570,220,Mobile Home,220,0,0.0,2025,92111
2571,18871,Total Units,19459,588,0.03022,2025,92111
2572,10788,Single Family - Detached,11063,275,0.02486,2030,92111
2573,8362,Multifamily,8713,351,0.04028,2030,92111
2574,219,Mobile Home,220,1,0.00455,2030,92111
2575,19369,Total Units,19996,627,0.03136,2030,92111
2576,10959,Single Family - Detached,11183,224,0.02003,2035,92111
2577,8447,Multifamily,8842,395,0.04467,2035,92111
2578,219,Mobile Home,220,1,0.00455,2035,92111
2579,19625,Total Units,20245,620,0.03062,2035,92111
2580,11032,Single Family - Detached,11293,261,0.02311,2040,92111
2581,10019,Multifamily,10527,508,0.04826,2040,92111
2582,219,Mobile Home,220,1,0.00455,2040,92111
2583,21270,Total Units,22040,770,0.03494,2040,92111
2584,11034,Single Family - Detached,11323,289,0.02552,2045,92111
2585,10336,Multifamily,10912,576,0.05279,2045,92111
2586,218,Mobile Home,220,2,0.00909,2045,92111
2587,21588,Total Units,22455,867,0.03861,2045,92111
2588,11045,Single Family - Detached,11343,298,0.02627,2050,92111
2589,10308,Multifamily,10925,617,0.05648,2050,92111
2590,214,Mobile Home,220,6,0.02727,2050,92111
2591,21567,Total Units,22488,921,0.04096,2050,92111
2592,8446,Single Family - Detached,8800,354,0.04023,2012,92113
2593,4415,Multifamily,4734,319,0.06738,2012,92113
2594,0,Mobile Home,0,0,,2012,92113
2595,12861,Total Units,13534,673,0.04973,2012,92113
2596,8332,Single Family - Detached,8727,395,0.04526,2020,92113
2597,5075,Multifamily,5499,424,0.0771,2020,92113
2598,0,Mobile Home,0,0,,2020,92113
2599,13407,Total Units,14226,819,0.05757,2020,92113
2600,8408,Single Family - Detached,8725,317,0.03633,2025,92113
2601,5362,Multifamily,5783,421,0.0728,2025,92113
2602,0,Mobile Home,0,0,,2025,92113
2603,13770,Total Units,14508,738,0.05087,2025,92113
2604,8461,Single Family - Detached,8853,392,0.04428,2030,92113
2605,6067,Multifamily,6640,573,0.0863,2030,92113
2606,0,Mobile Home,0,0,,2030,92113
2607,14528,Total Units,15493,965,0.06229,2030,92113
2608,8680,Single Family - Detached,9042,362,0.04004,2035,92113
2609,6502,Multifamily,7126,624,0.08757,2035,92113
2610,0,Mobile Home,0,0,,2035,92113
2611,15182,Total Units,16168,986,0.06098,2035,92113
2612,8440,Single Family - Detached,8840,400,0.04525,2040,92113
2613,7425,Multifamily,8192,767,0.09363,2040,92113
2614,0,Mobile Home,0,0,,2040,92113
2615,15865,Total Units,17032,1167,0.06852,2040,92113
2616,8516,Single Family - Detached,8946,430,0.04807,2045,92113
2617,8196,Multifamily,9093,897,0.09865,2045,92113
2618,0,Mobile Home,0,0,,2045,92113
2619,16712,Total Units,18039,1327,0.07356,2045,92113
2620,8375,Single Family - Detached,8804,429,0.04873,2050,92113
2621,9214,Multifamily,10195,981,0.09622,2050,92113
2622,0,Mobile Home,0,0,,2050,92113
2623,17589,Total Units,18999,1410,0.07421,2050,92113
2624,15500,Single Family - Detached,16026,526,0.03282,2012,92114
2625,1410,Multifamily,1431,21,0.01468,2012,92114
2626,345,Mobile Home,345,0,0.0,2012,92114
2627,17255,Total Units,17802,547,0.03073,2012,92114
2628,15778,Single Family - Detached,16368,590,0.03605,2020,92114
2629,1418,Multifamily,1431,13,0.00908,2020,92114
2630,345,Mobile Home,345,0,0.0,2020,92114
2631,17541,Total Units,18144,603,0.03323,2020,92114
2632,15975,Single Family - Detached,16439,464,0.02823,2025,92114
2633,1866,Multifamily,1880,14,0.00745,2025,92114
2634,345,Mobile Home,345,0,0.0,2025,92114
2635,18186,Total Units,18664,478,0.02561,2025,92114
2636,16261,Single Family - Detached,16741,480,0.02867,2030,92114
2637,1879,Multifamily,1893,14,0.0074,2030,92114
2638,343,Mobile Home,345,2,0.0058,2030,92114
2639,18483,Total Units,18979,496,0.02613,2030,92114
2640,16414,Single Family - Detached,16870,456,0.02703,2035,92114
2641,1885,Multifamily,1898,13,0.00685,2035,92114
2642,343,Mobile Home,345,2,0.0058,2035,92114
2643,18642,Total Units,19113,471,0.02464,2035,92114
2644,16335,Single Family - Detached,16837,502,0.02982,2040,92114
2645,2527,Multifamily,2555,28,0.01096,2040,92114
2646,250,Mobile Home,250,0,0.0,2040,92114
2647,19112,Total Units,19642,530,0.02698,2040,92114
2648,16443,Single Family - Detached,17004,561,0.03299,2045,92114
2649,2780,Multifamily,2814,34,0.01208,2045,92114
2650,117,Mobile Home,118,1,0.00847,2045,92114
2651,19340,Total Units,19936,596,0.0299,2045,92114
2652,16436,Single Family - Detached,17005,569,0.03346,2050,92114
2653,2939,Multifamily,2977,38,0.01276,2050,92114
2654,2,Mobile Home,2,0,0.0,2050,92114
2655,19377,Total Units,19984,607,0.03037,2050,92114
2656,11010,Single Family - Detached,11424,414,0.03624,2012,92115
2657,10806,Multifamily,11156,350,0.03137,2012,92115
2658,0,Mobile Home,0,0,,2012,92115
2659,21816,Total Units,22580,764,0.03384,2012,92115
2660,10980,Single Family - Detached,11427,447,0.03912,2020,92115
2661,12354,Multifamily,12768,414,0.03242,2020,92115
2662,0,Mobile Home,0,0,,2020,92115
2663,23334,Total Units,24195,861,0.03559,2020,92115
2664,11014,Single Family - Detached,11395,381,0.03344,2025,92115
2665,15533,Multifamily,16008,475,0.02967,2025,92115
2666,0,Mobile Home,0,0,,2025,92115
2667,26547,Total Units,27403,856,0.03124,2025,92115
2668,10998,Single Family - Detached,11388,390,0.03425,2030,92115
2669,18208,Multifamily,18783,575,0.03061,2030,92115
2670,0,Mobile Home,0,0,,2030,92115
2671,29206,Total Units,30171,965,0.03198,2030,92115
2672,10831,Single Family - Detached,11174,343,0.0307,2035,92115
2673,21836,Multifamily,22470,634,0.02822,2035,92115
2674,0,Mobile Home,0,0,,2035,92115
2675,32667,Total Units,33644,977,0.02904,2035,92115
2676,10810,Single Family - Detached,11194,384,0.0343,2040,92115
2677,23022,Multifamily,23751,729,0.03069,2040,92115
2678,0,Mobile Home,0,0,,2040,92115
2679,33832,Total Units,34945,1113,0.03185,2040,92115
2680,10644,Single Family - Detached,11070,426,0.03848,2045,92115
2681,25228,Multifamily,26033,805,0.03092,2045,92115
2682,0,Mobile Home,0,0,,2045,92115
2683,35872,Total Units,37103,1231,0.03318,2045,92115
2684,10326,Single Family - Detached,10745,419,0.03899,2050,92115
2685,30333,Multifamily,31237,904,0.02894,2050,92115
2686,0,Mobile Home,0,0,,2050,92115
2687,40659,Total Units,41982,1323,0.03151,2050,92115
2688,7456,Single Family - Detached,7687,231,0.03005,2012,92116
2689,8840,Multifamily,9229,389,0.04215,2012,92116
2690,0,Mobile Home,0,0,,2012,92116
2691,16296,Total Units,16916,620,0.03665,2012,92116
2692,7413,Single Family - Detached,7613,200,0.02627,2020,92116
2693,9289,Multifamily,9707,418,0.04306,2020,92116
2694,0,Mobile Home,0,0,,2020,92116
2695,16702,Total Units,17320,618,0.03568,2020,92116
2696,7175,Single Family - Detached,7330,155,0.02115,2025,92116
2697,10526,Multifamily,10899,373,0.03422,2025,92116
2698,0,Mobile Home,0,0,,2025,92116
2699,17701,Total Units,18229,528,0.02896,2025,92116
2700,6737,Single Family - Detached,6878,141,0.0205,2030,92116
2701,11593,Multifamily,11969,376,0.03141,2030,92116
2702,0,Mobile Home,0,0,,2030,92116
2703,18330,Total Units,18847,517,0.02743,2030,92116
2704,6481,Single Family - Detached,6609,128,0.01937,2035,92116
2705,12324,Multifamily,12699,375,0.02953,2035,92116
2706,0,Mobile Home,0,0,,2035,92116
2707,18805,Total Units,19308,503,0.02605,2035,92116
2708,6441,Single Family - Detached,6589,148,0.02246,2040,92116
2709,12258,Multifamily,12736,478,0.03753,2040,92116
2710,0,Mobile Home,0,0,,2040,92116
2711,18699,Total Units,19325,626,0.03239,2040,92116
2712,6460,Single Family - Detached,6627,167,0.0252,2045,92116
2713,12168,Multifamily,12736,568,0.0446,2045,92116
2714,0,Mobile Home,0,0,,2045,92116
2715,18628,Total Units,19363,735,0.03796,2045,92116
2716,6454,Single Family - Detached,6631,177,0.02669,2050,92116
2717,12050,Multifamily,12736,686,0.05386,2050,92116
2718,0,Mobile Home,0,0,,2050,92116
2719,18504,Total Units,19367,863,0.04456,2050,92116
2720,14428,Single Family - Detached,14859,431,0.02901,2012,92117
2721,5722,Multifamily,5995,273,0.04554,2012,92117
2722,325,Mobile Home,325,0,0.0,2012,92117
2723,20475,Total Units,21179,704,0.03324,2012,92117
2724,14413,Single Family - Detached,14884,471,0.03164,2020,92117
2725,6052,Multifamily,6348,296,0.04663,2020,92117
2726,0,Mobile Home,0,0,,2020,92117
2727,20465,Total Units,21232,767,0.03612,2020,92117
2728,14473,Single Family - Detached,14864,391,0.02631,2025,92117
2729,6389,Multifamily,6665,276,0.04141,2025,92117
2730,0,Mobile Home,0,0,,2025,92117
2731,20862,Total Units,21529,667,0.03098,2025,92117
2732,14551,Single Family - Detached,14950,399,0.02669,2030,92117
2733,6852,Multifamily,7142,290,0.0406,2030,92117
2734,0,Mobile Home,0,0,,2030,92117
2735,21403,Total Units,22092,689,0.03119,2030,92117
2736,14659,Single Family - Detached,15035,376,0.02501,2035,92117
2737,7159,Multifamily,7438,279,0.03751,2035,92117
2738,0,Mobile Home,0,0,,2035,92117
2739,21818,Total Units,22473,655,0.02915,2035,92117
2740,14614,Single Family - Detached,15024,410,0.02729,2040,92117
2741,9240,Multifamily,9681,441,0.04555,2040,92117
2742,0,Mobile Home,0,0,,2040,92117
2743,23854,Total Units,24705,851,0.03445,2040,92117
2744,14623,Single Family - Detached,15040,417,0.02773,2045,92117
2745,9818,Multifamily,10331,513,0.04966,2045,92117
2746,0,Mobile Home,0,0,,2045,92117
2747,24441,Total Units,25371,930,0.03666,2045,92117
2748,14640,Single Family - Detached,15066,426,0.02828,2050,92117
2749,9818,Multifamily,10347,529,0.05113,2050,92117
2750,0,Mobile Home,0,0,,2050,92117
2751,24458,Total Units,25413,955,0.03758,2050,92117
2752,4588,Single Family - Detached,5363,775,0.14451,2012,92118
2753,2850,Multifamily,4146,1296,0.31259,2012,92118
2754,0,Mobile Home,0,0,,2012,92118
2755,7438,Total Units,9509,2071,0.21779,2012,92118
2756,4571,Single Family - Detached,5404,833,0.15415,2020,92118
2757,2872,Multifamily,4177,1305,0.31243,2020,92118
2758,0,Mobile Home,0,0,,2020,92118
2759,7443,Total Units,9581,2138,0.22315,2020,92118
2760,4642,Single Family - Detached,5394,752,0.13941,2025,92118
2761,2945,Multifamily,4199,1254,0.29864,2025,92118
2762,0,Mobile Home,0,0,,2025,92118
2763,7587,Total Units,9593,2006,0.20911,2025,92118
2764,4622,Single Family - Detached,5380,758,0.14089,2030,92118
2765,2959,Multifamily,4222,1263,0.29915,2030,92118
2766,0,Mobile Home,0,0,,2030,92118
2767,7581,Total Units,9602,2021,0.21048,2030,92118
2768,4640,Single Family - Detached,5371,731,0.1361,2035,92118
2769,2993,Multifamily,4239,1246,0.29394,2035,92118
2770,0,Mobile Home,0,0,,2035,92118
2771,7633,Total Units,9610,1977,0.20572,2035,92118
2772,4613,Single Family - Detached,5320,707,0.13289,2040,92118
2773,3086,Multifamily,4347,1261,0.29009,2040,92118
2774,0,Mobile Home,0,0,,2040,92118
2775,7699,Total Units,9667,1968,0.20358,2040,92118
2776,4554,Single Family - Detached,5287,733,0.13864,2045,92118
2777,3117,Multifamily,4408,1291,0.29288,2045,92118
2778,0,Mobile Home,0,0,,2045,92118
2779,7671,Total Units,9695,2024,0.20877,2045,92118
2780,4533,Single Family - Detached,5274,741,0.1405,2050,92118
2781,3135,Multifamily,4440,1305,0.29392,2050,92118
2782,0,Mobile Home,0,0,,2050,92118
2783,7668,Total Units,9714,2046,0.21062,2050,92118
2784,7420,Single Family - Detached,7525,105,0.01395,2012,92119
2785,2177,Multifamily,2248,71,0.03158,2012,92119
2786,0,Mobile Home,0,0,,2012,92119
2787,9597,Total Units,9773,176,0.01801,2012,92119
2788,7409,Single Family - Detached,7525,116,0.01542,2020,92119
2789,2181,Multifamily,2248,67,0.0298,2020,92119
2790,0,Mobile Home,0,0,,2020,92119
2791,9590,Total Units,9773,183,0.01873,2020,92119
2792,7442,Single Family - Detached,7531,89,0.01182,2025,92119
2793,2238,Multifamily,2299,61,0.02653,2025,92119
2794,0,Mobile Home,0,0,,2025,92119
2795,9680,Total Units,9830,150,0.01526,2025,92119
2796,7450,Single Family - Detached,7541,91,0.01207,2030,92119
2797,2281,Multifamily,2346,65,0.02771,2030,92119
2798,0,Mobile Home,0,0,,2030,92119
2799,9731,Total Units,9887,156,0.01578,2030,92119
2800,7468,Single Family - Detached,7548,80,0.0106,2035,92119
2801,2281,Multifamily,2346,65,0.02771,2035,92119
2802,0,Mobile Home,0,0,,2035,92119
2803,9749,Total Units,9894,145,0.01466,2035,92119
2804,7465,Single Family - Detached,7560,95,0.01257,2040,92119
2805,2275,Multifamily,2346,71,0.03026,2040,92119
2806,0,Mobile Home,0,0,,2040,92119
2807,9740,Total Units,9906,166,0.01676,2040,92119
2808,7459,Single Family - Detached,7560,101,0.01336,2045,92119
2809,2272,Multifamily,2346,74,0.03154,2045,92119
2810,0,Mobile Home,0,0,,2045,92119
2811,9731,Total Units,9906,175,0.01767,2045,92119
2812,7454,Single Family - Detached,7560,106,0.01402,2050,92119
2813,2270,Multifamily,2346,76,0.0324,2050,92119
2814,0,Mobile Home,0,0,,2050,92119
2815,9724,Total Units,9906,182,0.01837,2050,92119
2816,8314,Single Family - Detached,8533,219,0.02567,2012,92120
2817,2265,Multifamily,2356,91,0.03862,2012,92120
2818,361,Mobile Home,370,9,0.02432,2012,92120
2819,10940,Total Units,11259,319,0.02833,2012,92120
2820,8418,Single Family - Detached,8660,242,0.02794,2020,92120
2821,4487,Multifamily,4694,207,0.0441,2020,92120
2822,246,Mobile Home,251,5,0.01992,2020,92120
2823,13151,Total Units,13605,454,0.03337,2020,92120
2824,8429,Single Family - Detached,8660,231,0.02667,2025,92120
2825,5659,Multifamily,5888,229,0.03889,2025,92120
2826,246,Mobile Home,251,5,0.01992,2025,92120
2827,14334,Total Units,14799,465,0.03142,2025,92120
2828,8425,Single Family - Detached,8661,236,0.02725,2030,92120
2829,7386,Multifamily,7688,302,0.03928,2030,92120
2830,245,Mobile Home,251,6,0.0239,2030,92120
2831,16056,Total Units,16600,544,0.03277,2030,92120
2832,8430,Single Family - Detached,8661,231,0.02667,2035,92120
2833,10069,Multifamily,10446,377,0.03609,2035,92120
2834,245,Mobile Home,251,6,0.0239,2035,92120
2835,18744,Total Units,19358,614,0.03172,2035,92120
2836,8418,Single Family - Detached,8661,243,0.02806,2040,92120
2837,10515,Multifamily,10948,433,0.03955,2040,92120
2838,246,Mobile Home,251,5,0.01992,2040,92120
2839,19179,Total Units,19860,681,0.03429,2040,92120
2840,8410,Single Family - Detached,8661,251,0.02898,2045,92120
2841,10808,Multifamily,11284,476,0.04218,2045,92120
2842,245,Mobile Home,251,6,0.0239,2045,92120
2843,19463,Total Units,20196,733,0.03629,2045,92120
2844,8407,Single Family - Detached,8660,253,0.02921,2050,92120
2845,10961,Multifamily,11459,498,0.04346,2050,92120
2846,240,Mobile Home,251,11,0.04382,2050,92120
2847,19608,Total Units,20370,762,0.03741,2050,92120
2848,660,Single Family - Detached,656,-4,-0.0061,2012,92121
2849,1059,Multifamily,1074,15,0.01397,2012,92121
2850,0,Mobile Home,0,0,,2012,92121
2851,1719,Total Units,1730,11,0.00636,2012,92121
2852,704,Single Family - Detached,702,-2,-0.00285,2020,92121
2853,1234,Multifamily,1253,19,0.01516,2020,92121
2854,0,Mobile Home,0,0,,2020,92121
2855,1938,Total Units,1955,17,0.0087,2020,92121
2856,707,Single Family - Detached,705,-2,-0.00284,2025,92121
2857,1245,Multifamily,1255,10,0.00797,2025,92121
2858,0,Mobile Home,0,0,,2025,92121
2859,1952,Total Units,1960,8,0.00408,2025,92121
2860,708,Single Family - Detached,707,-1,-0.00141,2030,92121
2861,1246,Multifamily,1258,12,0.00954,2030,92121
2862,0,Mobile Home,0,0,,2030,92121
2863,1954,Total Units,1965,11,0.0056,2030,92121
2864,719,Single Family - Detached,717,-2,-0.00279,2035,92121
2865,1251,Multifamily,1259,8,0.00635,2035,92121
2866,0,Mobile Home,0,0,,2035,92121
2867,1970,Total Units,1976,6,0.00304,2035,92121
2868,720,Single Family - Detached,718,-2,-0.00279,2040,92121
2869,1274,Multifamily,1291,17,0.01317,2040,92121
2870,0,Mobile Home,0,0,,2040,92121
2871,1994,Total Units,2009,15,0.00747,2040,92121
2872,719,Single Family - Detached,718,-1,-0.00139,2045,92121
2873,1297,Multifamily,1339,42,0.03137,2045,92121
2874,0,Mobile Home,0,0,,2045,92121
2875,2016,Total Units,2057,41,0.01993,2045,92121
2876,720,Single Family - Detached,718,-2,-0.00279,2050,92121
2877,1294,Multifamily,1339,45,0.03361,2050,92121
2878,0,Mobile Home,0,0,,2050,92121
2879,2014,Total Units,2057,43,0.0209,2050,92121
2880,4864,Single Family - Detached,5028,164,0.03262,2012,92122
2881,14984,Multifamily,15871,887,0.05589,2012,92122
2882,0,Mobile Home,0,0,,2012,92122
2883,19848,Total Units,20899,1051,0.05029,2012,92122
2884,4854,Single Family - Detached,5030,176,0.03499,2020,92122
2885,16846,Multifamily,17833,987,0.05535,2020,92122
2886,0,Mobile Home,0,0,,2020,92122
2887,21700,Total Units,22863,1163,0.05087,2020,92122
2888,4887,Single Family - Detached,5039,152,0.03016,2025,92122
2889,17099,Multifamily,17971,872,0.04852,2025,92122
2890,0,Mobile Home,0,0,,2025,92122
2891,21986,Total Units,23010,1024,0.0445,2025,92122
2892,4892,Single Family - Detached,5046,154,0.03052,2030,92122
2893,17153,Multifamily,18037,884,0.04901,2030,92122
2894,0,Mobile Home,0,0,,2030,92122
2895,22045,Total Units,23083,1038,0.04497,2030,92122
2896,4904,Single Family - Detached,5050,146,0.02891,2035,92122
2897,17182,Multifamily,18038,856,0.04746,2035,92122
2898,0,Mobile Home,0,0,,2035,92122
2899,22086,Total Units,23088,1002,0.0434,2035,92122
2900,4904,Single Family - Detached,5060,156,0.03083,2040,92122
2901,17175,Multifamily,18080,905,0.05006,2040,92122
2902,0,Mobile Home,0,0,,2040,92122
2903,22079,Total Units,23140,1061,0.04585,2040,92122
2904,4895,Single Family - Detached,5062,167,0.03299,2045,92122
2905,17220,Multifamily,18131,911,0.05025,2045,92122
2906,0,Mobile Home,0,0,,2045,92122
2907,22115,Total Units,23193,1078,0.04648,2045,92122
2908,4901,Single Family - Detached,5069,168,0.03314,2050,92122
2909,17209,Multifamily,18135,926,0.05106,2050,92122
2910,0,Mobile Home,0,0,,2050,92122
2911,22110,Total Units,23204,1094,0.04715,2050,92122
2912,4831,Single Family - Detached,5037,206,0.0409,2012,92123
2913,5294,Multifamily,5833,539,0.09241,2012,92123
2914,0,Mobile Home,0,0,,2012,92123
2915,10125,Total Units,10870,745,0.06854,2012,92123
2916,4827,Single Family - Detached,5037,210,0.04169,2020,92123
2917,6656,Multifamily,7440,784,0.10538,2020,92123
2918,0,Mobile Home,0,0,,2020,92123
2919,11483,Total Units,12477,994,0.07967,2020,92123
2920,4880,Single Family - Detached,5057,177,0.035,2025,92123
2921,6961,Multifamily,7670,709,0.09244,2025,92123
2922,0,Mobile Home,0,0,,2025,92123
2923,11841,Total Units,12727,886,0.06962,2025,92123
2924,4896,Single Family - Detached,5076,180,0.03546,2030,92123
2925,7014,Multifamily,7739,725,0.09368,2030,92123
2926,0,Mobile Home,0,0,,2030,92123
2927,11910,Total Units,12815,905,0.07062,2030,92123
2928,4909,Single Family - Detached,5078,169,0.03328,2035,92123
2929,7115,Multifamily,7813,698,0.08934,2035,92123
2930,0,Mobile Home,0,0,,2035,92123
2931,12024,Total Units,12891,867,0.06726,2035,92123
2932,4916,Single Family - Detached,5100,184,0.03608,2040,92123
2933,7244,Multifamily,7989,745,0.09325,2040,92123
2934,0,Mobile Home,0,0,,2040,92123
2935,12160,Total Units,13089,929,0.07098,2040,92123
2936,4909,Single Family - Detached,5108,199,0.03896,2045,92123
2937,7271,Multifamily,8036,765,0.0952,2045,92123
2938,0,Mobile Home,0,0,,2045,92123
2939,12180,Total Units,13144,964,0.07334,2045,92123
2940,4915,Single Family - Detached,5118,203,0.03966,2050,92123
2941,7236,Multifamily,8008,772,0.0964,2050,92123
2942,0,Mobile Home,0,0,,2050,92123
2943,12151,Total Units,13126,975,0.07428,2050,92123
2944,8347,Single Family - Detached,8508,161,0.01892,2012,92124
2945,2766,Multifamily,2928,162,0.05533,2012,92124
2946,0,Mobile Home,0,0,,2012,92124
2947,11113,Total Units,11436,323,0.02824,2012,92124
2948,8340,Single Family - Detached,8508,168,0.01975,2020,92124
2949,4078,Multifamily,4328,250,0.05776,2020,92124
2950,0,Mobile Home,0,0,,2020,92124
2951,12418,Total Units,12836,418,0.03256,2020,92124
2952,8350,Single Family - Detached,8508,158,0.01857,2025,92124
2953,4124,Multifamily,4371,247,0.05651,2025,92124
2954,0,Mobile Home,0,0,,2025,92124
2955,12474,Total Units,12879,405,0.03145,2025,92124
2956,8350,Single Family - Detached,8508,158,0.01857,2030,92124
2957,4210,Multifamily,4460,250,0.05605,2030,92124
2958,0,Mobile Home,0,0,,2030,92124
2959,12560,Total Units,12968,408,0.03146,2030,92124
2960,8356,Single Family - Detached,8508,152,0.01787,2035,92124
2961,4324,Multifamily,4570,246,0.05383,2035,92124
2962,0,Mobile Home,0,0,,2035,92124
2963,12680,Total Units,13078,398,0.03043,2035,92124
2964,8344,Single Family - Detached,8508,164,0.01928,2040,92124
2965,4340,Multifamily,4596,256,0.0557,2040,92124
2966,0,Mobile Home,0,0,,2040,92124
2967,12684,Total Units,13104,420,0.03205,2040,92124
2968,8337,Single Family - Detached,8508,171,0.0201,2045,92124
2969,4355,Multifamily,4613,258,0.05593,2045,92124
2970,0,Mobile Home,0,0,,2045,92124
2971,12692,Total Units,13121,429,0.0327,2045,92124
2972,8337,Single Family - Detached,8508,171,0.0201,2050,92124
2973,4362,Multifamily,4622,260,0.05625,2050,92124
2974,0,Mobile Home,0,0,,2050,92124
2975,12699,Total Units,13130,431,0.03283,2050,92124
2976,15392,Single Family - Detached,15854,462,0.02914,2012,92126
2977,7493,Multifamily,7681,188,0.02448,2012,92126
2978,225,Mobile Home,286,61,0.21329,2012,92126
2979,23110,Total Units,23821,711,0.02985,2012,92126
2980,15491,Single Family - Detached,15983,492,0.03078,2020,92126
2981,12396,Multifamily,12745,349,0.02738,2020,92126
2982,226,Mobile Home,286,60,0.20979,2020,92126
2983,28113,Total Units,29014,901,0.03105,2020,92126
2984,15536,Single Family - Detached,15983,447,0.02797,2025,92126
2985,14313,Multifamily,14651,338,0.02307,2025,92126
2986,226,Mobile Home,286,60,0.20979,2025,92126
2987,30075,Total Units,30920,845,0.02733,2025,92126
2988,15534,Single Family - Detached,15983,449,0.02809,2030,92126
2989,16005,Multifamily,16396,391,0.02385,2030,92126
2990,93,Mobile Home,119,26,0.21849,2030,92126
2991,31632,Total Units,32498,866,0.02665,2030,92126
2992,15553,Single Family - Detached,15983,430,0.0269,2035,92126
2993,16871,Multifamily,17267,396,0.02293,2035,92126
2994,64,Mobile Home,80,16,0.2,2035,92126
2995,32488,Total Units,33330,842,0.02526,2035,92126
2996,15523,Single Family - Detached,15983,460,0.02878,2040,92126
2997,16945,Multifamily,17387,442,0.02542,2040,92126
2998,24,Mobile Home,30,6,0.2,2040,92126
2999,32492,Total Units,33400,908,0.02719,2040,92126
3000,15509,Single Family - Detached,15983,474,0.02966,2045,92126
3001,17000,Multifamily,17456,456,0.02612,2045,92126
3002,0,Mobile Home,0,0,,2045,92126
3003,32509,Total Units,33439,930,0.02781,2045,92126
3004,15509,Single Family - Detached,15983,474,0.02966,2050,92126
3005,16988,Multifamily,17457,469,0.02687,2050,92126
3006,0,Mobile Home,0,0,,2050,92126
3007,32497,Total Units,33440,943,0.0282,2050,92126
3008,9358,Single Family - Detached,9650,292,0.03026,2012,92127
3009,4581,Multifamily,4766,185,0.03882,2012,92127
3010,0,Mobile Home,0,0,,2012,92127
3011,13939,Total Units,14416,477,0.03309,2012,92127
3012,10598,Single Family - Detached,10971,373,0.034,2020,92127
3013,5469,Multifamily,5646,177,0.03135,2020,92127
3014,0,Mobile Home,0,0,,2020,92127
3015,16067,Total Units,16617,550,0.0331,2020,92127
3016,10697,Single Family - Detached,11024,327,0.02966,2025,92127
3017,5480,Multifamily,5647,167,0.02957,2025,92127
3018,0,Mobile Home,0,0,,2025,92127
3019,16177,Total Units,16671,494,0.02963,2025,92127
3020,10842,Single Family - Detached,11204,362,0.03231,2030,92127
3021,5480,Multifamily,5647,167,0.02957,2030,92127
3022,0,Mobile Home,0,0,,2030,92127
3023,16322,Total Units,16851,529,0.03139,2030,92127
3024,10864,Single Family - Detached,11205,341,0.03043,2035,92127
3025,5484,Multifamily,5647,163,0.02886,2035,92127
3026,0,Mobile Home,0,0,,2035,92127
3027,16348,Total Units,16852,504,0.02991,2035,92127
3028,10965,Single Family - Detached,11340,375,0.03307,2040,92127
3029,5474,Multifamily,5647,173,0.03064,2040,92127
3030,0,Mobile Home,0,0,,2040,92127
3031,16439,Total Units,16987,548,0.03226,2040,92127
3032,11028,Single Family - Detached,11439,411,0.03593,2045,92127
3033,5472,Multifamily,5647,175,0.03099,2045,92127
3034,0,Mobile Home,0,0,,2045,92127
3035,16500,Total Units,17086,586,0.0343,2045,92127
3036,11042,Single Family - Detached,11464,422,0.03681,2050,92127
3037,5470,Multifamily,5647,177,0.03134,2050,92127
3038,0,Mobile Home,0,0,,2050,92127
3039,16512,Total Units,17111,599,0.03501,2050,92127
3040,14246,Single Family - Detached,14844,598,0.04029,2012,92128
3041,6270,Multifamily,6458,188,0.02911,2012,92128
3042,0,Mobile Home,0,0,,2012,92128
3043,20516,Total Units,21302,786,0.0369,2012,92128
3044,14201,Single Family - Detached,14846,645,0.04345,2020,92128
3045,6284,Multifamily,6460,176,0.02724,2020,92128
3046,0,Mobile Home,0,0,,2020,92128
3047,20485,Total Units,21306,821,0.03853,2020,92128
3048,14264,Single Family - Detached,14857,593,0.03991,2025,92128
3049,6302,Multifamily,6464,162,0.02506,2025,92128
3050,0,Mobile Home,0,0,,2025,92128
3051,20566,Total Units,21321,755,0.03541,2025,92128
3052,14271,Single Family - Detached,14868,597,0.04015,2030,92128
3053,6302,Multifamily,6464,162,0.02506,2030,92128
3054,0,Mobile Home,0,0,,2030,92128
3055,20573,Total Units,21332,759,0.03558,2030,92128
3056,14294,Single Family - Detached,14870,576,0.03874,2035,92128
3057,6305,Multifamily,6464,159,0.0246,2035,92128
3058,0,Mobile Home,0,0,,2035,92128
3059,20599,Total Units,21334,735,0.03445,2035,92128
3060,14279,Single Family - Detached,14885,606,0.04071,2040,92128
3061,6291,Multifamily,6464,173,0.02676,2040,92128
3062,0,Mobile Home,0,0,,2040,92128
3063,20570,Total Units,21349,779,0.03649,2040,92128
3064,14258,Single Family - Detached,14891,633,0.04251,2045,92128
3065,6288,Multifamily,6464,176,0.02723,2045,92128
3066,0,Mobile Home,0,0,,2045,92128
3067,20546,Total Units,21355,809,0.03788,2045,92128
3068,14275,Single Family - Detached,14915,640,0.04291,2050,92128
3069,6285,Multifamily,6464,179,0.02769,2050,92128
3070,0,Mobile Home,0,0,,2050,92128
3071,20560,Total Units,21379,819,0.03831,2050,92128
3072,12513,Single Family - Detached,12670,157,0.01239,2012,92129
3073,4962,Multifamily,5088,126,0.02476,2012,92129
3074,0,Mobile Home,0,0,,2012,92129
3075,17475,Total Units,17758,283,0.01594,2012,92129
3076,13115,Single Family - Detached,13313,198,0.01487,2020,92129
3077,5568,Multifamily,5694,126,0.02213,2020,92129
3078,0,Mobile Home,0,0,,2020,92129
3079,18683,Total Units,19007,324,0.01705,2020,92129
3080,13185,Single Family - Detached,13335,150,0.01125,2025,92129
3081,5599,Multifamily,5710,111,0.01944,2025,92129
3082,0,Mobile Home,0,0,,2025,92129
3083,18784,Total Units,19045,261,0.0137,2025,92129
3084,13202,Single Family - Detached,13356,154,0.01153,2030,92129
3085,5599,Multifamily,5710,111,0.01944,2030,92129
3086,0,Mobile Home,0,0,,2030,92129
3087,18801,Total Units,19066,265,0.0139,2030,92129
3088,13227,Single Family - Detached,13362,135,0.0101,2035,92129
3089,5604,Multifamily,5710,106,0.01856,2035,92129
3090,0,Mobile Home,0,0,,2035,92129
3091,18831,Total Units,19072,241,0.01264,2035,92129
3092,13238,Single Family - Detached,13398,160,0.01194,2040,92129
3093,5591,Multifamily,5710,119,0.02084,2040,92129
3094,0,Mobile Home,0,0,,2040,92129
3095,18829,Total Units,19108,279,0.0146,2040,92129
3096,13230,Single Family - Detached,13414,184,0.01372,2045,92129
3097,5589,Multifamily,5710,121,0.02119,2045,92129
3098,0,Mobile Home,0,0,,2045,92129
3099,18819,Total Units,19124,305,0.01595,2045,92129
3100,13267,Single Family - Detached,13454,187,0.0139,2050,92129
3101,5587,Multifamily,5710,123,0.02154,2050,92129
3102,0,Mobile Home,0,0,,2050,92129
3103,18854,Total Units,19164,310,0.01618,2050,92129
3104,11152,Single Family - Detached,11413,261,0.02287,2012,92130
3105,7151,Multifamily,7539,388,0.05147,2012,92130
3106,0,Mobile Home,0,0,,2012,92130
3107,18303,Total Units,18952,649,0.03424,2012,92130
3108,14188,Single Family - Detached,14494,306,0.02111,2020,92130
3109,8231,Multifamily,8643,412,0.04767,2020,92130
3110,0,Mobile Home,0,0,,2020,92130
3111,22419,Total Units,23137,718,0.03103,2020,92130
3112,14268,Single Family - Detached,14506,238,0.01641,2025,92130
3113,8298,Multifamily,8659,361,0.04169,2025,92130
3114,0,Mobile Home,0,0,,2025,92130
3115,22566,Total Units,23165,599,0.02586,2025,92130
3116,14273,Single Family - Detached,14517,244,0.01681,2030,92130
3117,8298,Multifamily,8659,361,0.04169,2030,92130
3118,0,Mobile Home,0,0,,2030,92130
3119,22571,Total Units,23176,605,0.0261,2030,92130
3120,14305,Single Family - Detached,14524,219,0.01508,2035,92130
3121,8305,Multifamily,8659,354,0.04088,2035,92130
3122,0,Mobile Home,0,0,,2035,92130
3123,22610,Total Units,23183,573,0.02472,2035,92130
3124,14282,Single Family - Detached,14534,252,0.01734,2040,92130
3125,8286,Multifamily,8659,373,0.04308,2040,92130
3126,0,Mobile Home,0,0,,2040,92130
3127,22568,Total Units,23193,625,0.02695,2040,92130
3128,14254,Single Family - Detached,14538,284,0.01954,2045,92130
3129,8281,Multifamily,8659,378,0.04365,2045,92130
3130,0,Mobile Home,0,0,,2045,92130
3131,22535,Total Units,23197,662,0.02854,2045,92130
3132,14260,Single Family - Detached,14554,294,0.0202,2050,92130
3133,8276,Multifamily,8659,383,0.04423,2050,92130
3134,0,Mobile Home,0,0,,2050,92130
3135,22536,Total Units,23213,677,0.02916,2050,92130
3136,9627,Single Family - Detached,9733,106,0.01089,2012,92131
3137,2522,Multifamily,2614,92,0.0352,2012,92131
3138,0,Mobile Home,0,0,,2012,92131
3139,12149,Total Units,12347,198,0.01604,2012,92131
3140,9783,Single Family - Detached,9905,122,0.01232,2020,92131
3141,2665,Multifamily,2760,95,0.03442,2020,92131
3142,0,Mobile Home,0,0,,2020,92131
3143,12448,Total Units,12665,217,0.01713,2020,92131
3144,9836,Single Family - Detached,9927,91,0.00917,2025,92131
3145,2805,Multifamily,2889,84,0.02908,2025,92131
3146,0,Mobile Home,0,0,,2025,92131
3147,12641,Total Units,12816,175,0.01365,2025,92131
3148,9854,Single Family - Detached,9948,94,0.00945,2030,92131
3149,2884,Multifamily,2970,86,0.02896,2030,92131
3150,0,Mobile Home,0,0,,2030,92131
3151,12738,Total Units,12918,180,0.01393,2030,92131
3152,9874,Single Family - Detached,9956,82,0.00824,2035,92131
3153,2914,Multifamily,2998,84,0.02802,2035,92131
3154,0,Mobile Home,0,0,,2035,92131
3155,12788,Total Units,12954,166,0.01281,2035,92131
3156,9877,Single Family - Detached,9978,101,0.01012,2040,92131
3157,3219,Multifamily,3310,91,0.02749,2040,92131
3158,0,Mobile Home,0,0,,2040,92131
3159,13096,Total Units,13288,192,0.01445,2040,92131
3160,9876,Single Family - Detached,9988,112,0.01121,2045,92131
3161,3499,Multifamily,3593,94,0.02616,2045,92131
3162,0,Mobile Home,0,0,,2045,92131
3163,13375,Total Units,13581,206,0.01517,2045,92131
3164,9893,Single Family - Detached,10009,116,0.01159,2050,92131
3165,3497,Multifamily,3593,96,0.02672,2050,92131
3166,0,Mobile Home,0,0,,2050,92131
3167,13390,Total Units,13602,212,0.01559,2050,92131
3168,0,Single Family - Detached,0,0,,2012,92134
3169,13,Multifamily,13,0,0.0,2012,92134
3170,0,Mobile Home,0,0,,2012,92134
3171,13,Total Units,13,0,0.0,2012,92134
3172,0,Single Family - Detached,0,0,,2020,92134
3173,13,Multifamily,13,0,0.0,2020,92134
3174,0,Mobile Home,0,0,,2020,92134
3175,13,Total Units,13,0,0.0,2020,92134
3176,0,Single Family - Detached,0,0,,2025,92134
3177,13,Multifamily,13,0,0.0,2025,92134
3178,0,Mobile Home,0,0,,2025,92134
3179,13,Total Units,13,0,0.0,2025,92134
3180,0,Single Family - Detached,0,0,,2030,92134
3181,13,Multifamily,13,0,0.0,2030,92134
3182,0,Mobile Home,0,0,,2030,92134
3183,13,Total Units,13,0,0.0,2030,92134
3184,0,Single Family - Detached,0,0,,2035,92134
3185,13,Multifamily,13,0,0.0,2035,92134
3186,0,Mobile Home,0,0,,2035,92134
3187,13,Total Units,13,0,0.0,2035,92134
3188,0,Single Family - Detached,0,0,,2040,92134
3189,13,Multifamily,13,0,0.0,2040,92134
3190,0,Mobile Home,0,0,,2040,92134
3191,13,Total Units,13,0,0.0,2040,92134
3192,0,Single Family - Detached,0,0,,2045,92134
3193,13,Multifamily,13,0,0.0,2045,92134
3194,0,Mobile Home,0,0,,2045,92134
3195,13,Total Units,13,0,0.0,2045,92134
3196,0,Single Family - Detached,0,0,,2050,92134
3197,13,Multifamily,13,0,0.0,2050,92134
3198,0,Mobile Home,0,0,,2050,92134
3199,13,Total Units,13,0,0.0,2050,92134
3200,38,Single Family - Detached,54,16,0.2963,2012,92135
3201,0,Multifamily,0,0,,2012,92135
3202,0,Mobile Home,0,0,,2012,92135
3203,38,Total Units,54,16,0.2963,2012,92135
3204,39,Single Family - Detached,54,15,0.27778,2020,92135
3205,0,Multifamily,0,0,,2020,92135
3206,0,Mobile Home,0,0,,2020,92135
3207,39,Total Units,54,15,0.27778,2020,92135
3208,40,Single Family - Detached,54,14,0.25926,2025,92135
3209,0,Multifamily,0,0,,2025,92135
3210,0,Mobile Home,0,0,,2025,92135
3211,40,Total Units,54,14,0.25926,2025,92135
3212,39,Single Family - Detached,54,15,0.27778,2030,92135
3213,0,Multifamily,0,0,,2030,92135
3214,0,Mobile Home,0,0,,2030,92135
3215,39,Total Units,54,15,0.27778,2030,92135
3216,40,Single Family - Detached,54,14,0.25926,2035,92135
3217,0,Multifamily,0,0,,2035,92135
3218,0,Mobile Home,0,0,,2035,92135
3219,40,Total Units,54,14,0.25926,2035,92135
3220,40,Single Family - Detached,54,14,0.25926,2040,92135
3221,0,Multifamily,0,0,,2040,92135
3222,0,Mobile Home,0,0,,2040,92135
3223,40,Total Units,54,14,0.25926,2040,92135
3224,39,Single Family - Detached,54,15,0.27778,2045,92135
3225,0,Multifamily,0,0,,2045,92135
3226,0,Mobile Home,0,0,,2045,92135
3227,39,Total Units,54,15,0.27778,2045,92135
3228,40,Single Family - Detached,54,14,0.25926,2050,92135
3229,0,Multifamily,0,0,,2050,92135
3230,0,Mobile Home,0,0,,2050,92135
3231,40,Total Units,54,14,0.25926,2050,92135
3232,0,Single Family - Detached,0,0,,2012,92136
3233,0,Multifamily,0,0,,2012,92136
3234,0,Mobile Home,0,0,,2012,92136
3235,0,Total Units,0,0,,2012,92136
3236,0,Single Family - Detached,0,0,,2020,92136
3237,0,Multifamily,0,0,,2020,92136
3238,0,Mobile Home,0,0,,2020,92136
3239,0,Total Units,0,0,,2020,92136
3240,0,Single Family - Detached,0,0,,2025,92136
3241,0,Multifamily,0,0,,2025,92136
3242,0,Mobile Home,0,0,,2025,92136
3243,0,Total Units,0,0,,2025,92136
3244,0,Single Family - Detached,0,0,,2030,92136
3245,0,Multifamily,0,0,,2030,92136
3246,0,Mobile Home,0,0,,2030,92136
3247,0,Total Units,0,0,,2030,92136
3248,0,Single Family - Detached,0,0,,2035,92136
3249,0,Multifamily,0,0,,2035,92136
3250,0,Mobile Home,0,0,,2035,92136
3251,0,Total Units,0,0,,2035,92136
3252,0,Single Family - Detached,0,0,,2040,92136
3253,0,Multifamily,0,0,,2040,92136
3254,0,Mobile Home,0,0,,2040,92136
3255,0,Total Units,0,0,,2040,92136
3256,0,Single Family - Detached,0,0,,2045,92136
3257,0,Multifamily,0,0,,2045,92136
3258,0,Mobile Home,0,0,,2045,92136
3259,0,Total Units,0,0,,2045,92136
3260,0,Single Family - Detached,0,0,,2050,92136
3261,0,Multifamily,0,0,,2050,92136
3262,0,Mobile Home,0,0,,2050,92136
3263,0,Total Units,0,0,,2050,92136
3264,8418,Single Family - Detached,8711,293,0.03364,2012,92139
3265,1787,Multifamily,1825,38,0.02082,2012,92139
3266,70,Mobile Home,83,13,0.15663,2012,92139
3267,10275,Total Units,10619,344,0.03239,2012,92139
3268,9073,Single Family - Detached,9422,349,0.03704,2020,92139
3269,1793,Multifamily,1825,32,0.01753,2020,92139
3270,71,Mobile Home,83,12,0.14458,2020,92139
3271,10937,Total Units,11330,393,0.03469,2020,92139
3272,9331,Single Family - Detached,9615,284,0.02954,2025,92139
3273,1851,Multifamily,1878,27,0.01438,2025,92139
3274,64,Mobile Home,75,11,0.14667,2025,92139
3275,11246,Total Units,11568,322,0.02784,2025,92139
3276,9523,Single Family - Detached,9820,297,0.03024,2030,92139
3277,1881,Multifamily,1909,28,0.01467,2030,92139
3278,54,Mobile Home,63,9,0.14286,2030,92139
3279,11458,Total Units,11792,334,0.02832,2030,92139
3280,9749,Single Family - Detached,10026,277,0.02763,2035,92139
3281,1905,Multifamily,1930,25,0.01295,2035,92139
3282,47,Mobile Home,54,7,0.12963,2035,92139
3283,11701,Total Units,12010,309,0.02573,2035,92139
3284,9750,Single Family - Detached,10057,307,0.03053,2040,92139
3285,1966,Multifamily,1997,31,0.01552,2040,92139
3286,22,Mobile Home,25,3,0.12,2040,92139
3287,11738,Total Units,12079,341,0.02823,2040,92139
3288,9722,Single Family - Detached,10063,341,0.03389,2045,92139
3289,2020,Multifamily,2054,34,0.01655,2045,92139
3290,0,Mobile Home,0,0,,2045,92139
3291,11742,Total Units,12117,375,0.03095,2045,92139
3292,9715,Single Family - Detached,10065,350,0.03477,2050,92139
3293,2019,Multifamily,2054,35,0.01704,2050,92139
3294,0,Mobile Home,0,0,,2050,92139
3295,11734,Total Units,12119,385,0.03177,2050,92139
3296,0,Single Family - Detached,0,0,,2012,92140
3297,7,Multifamily,7,0,0.0,2012,92140
3298,0,Mobile Home,0,0,,2012,92140
3299,7,Total Units,7,0,0.0,2012,92140
3300,0,Single Family - Detached,0,0,,2020,92140
3301,7,Multifamily,7,0,0.0,2020,92140
3302,0,Mobile Home,0,0,,2020,92140
3303,7,Total Units,7,0,0.0,2020,92140
3304,0,Single Family - Detached,0,0,,2025,92140
3305,7,Multifamily,7,0,0.0,2025,92140
3306,0,Mobile Home,0,0,,2025,92140
3307,7,Total Units,7,0,0.0,2025,92140
3308,0,Single Family - Detached,0,0,,2030,92140
3309,7,Multifamily,7,0,0.0,2030,92140
3310,0,Mobile Home,0,0,,2030,92140
3311,7,Total Units,7,0,0.0,2030,92140
3312,0,Single Family - Detached,0,0,,2035,92140
3313,7,Multifamily,7,0,0.0,2035,92140
3314,0,Mobile Home,0,0,,2035,92140
3315,7,Total Units,7,0,0.0,2035,92140
3316,0,Single Family - Detached,0,0,,2040,92140
3317,7,Multifamily,7,0,0.0,2040,92140
3318,0,Mobile Home,0,0,,2040,92140
3319,7,Total Units,7,0,0.0,2040,92140
3320,0,Single Family - Detached,0,0,,2045,92140
3321,7,Multifamily,7,0,0.0,2045,92140
3322,0,Mobile Home,0,0,,2045,92140
3323,7,Total Units,7,0,0.0,2045,92140
3324,0,Single Family - Detached,0,0,,2050,92140
3325,7,Multifamily,7,0,0.0,2050,92140
3326,0,Mobile Home,0,0,,2050,92140
3327,7,Total Units,7,0,0.0,2050,92140
3328,1,Single Family - Detached,0,-1,,2012,92145
3329,0,Multifamily,1,1,1.0,2012,92145
3330,0,Mobile Home,0,0,,2012,92145
3331,1,Total Units,1,0,0.0,2012,92145
3332,270,Single Family - Detached,283,13,0.04594,2020,92145
3333,144,Multifamily,148,4,0.02703,2020,92145
3334,0,Mobile Home,0,0,,2020,92145
3335,414,Total Units,431,17,0.03944,2020,92145
3336,270,Single Family - Detached,283,13,0.04594,2025,92145
3337,145,Multifamily,148,3,0.02027,2025,92145
3338,0,Mobile Home,0,0,,2025,92145
3339,415,Total Units,431,16,0.03712,2025,92145
3340,270,Single Family - Detached,283,13,0.04594,2030,92145
3341,145,Multifamily,148,3,0.02027,2030,92145
3342,0,Mobile Home,0,0,,2030,92145
3343,415,Total Units,431,16,0.03712,2030,92145
3344,270,Single Family - Detached,283,13,0.04594,2035,92145
3345,146,Multifamily,148,2,0.01351,2035,92145
3346,0,Mobile Home,0,0,,2035,92145
3347,416,Total Units,431,15,0.0348,2035,92145
3348,270,Single Family - Detached,283,13,0.04594,2040,92145
3349,146,Multifamily,148,2,0.01351,2040,92145
3350,0,Mobile Home,0,0,,2040,92145
3351,416,Total Units,431,15,0.0348,2040,92145
3352,270,Single Family - Detached,283,13,0.04594,2045,92145
3353,146,Multifamily,148,2,0.01351,2045,92145
3354,0,Mobile Home,0,0,,2045,92145
3355,416,Total Units,431,15,0.0348,2045,92145
3356,271,Single Family - Detached,283,12,0.0424,2050,92145
3357,146,Multifamily,148,2,0.01351,2050,92145
3358,0,Mobile Home,0,0,,2050,92145
3359,417,Total Units,431,14,0.03248,2050,92145
3360,12494,Single Family - Detached,12729,235,0.01846,2012,92154
3361,6247,Multifamily,6546,299,0.04568,2012,92154
3362,1761,Mobile Home,1921,160,0.08329,2012,92154
3363,20502,Total Units,21196,694,0.03274,2012,92154
3364,13363,Single Family - Detached,13659,296,0.02167,2020,92154
3365,8667,Multifamily,9043,376,0.04158,2020,92154
3366,1756,Mobile Home,1910,154,0.08063,2020,92154
3367,23786,Total Units,24612,826,0.03356,2020,92154
3368,13731,Single Family - Detached,13979,248,0.01774,2025,92154
3369,10692,Multifamily,11073,381,0.03441,2025,92154
3370,1646,Mobile Home,1790,144,0.08045,2025,92154
3371,26069,Total Units,26842,773,0.0288,2025,92154
3372,14403,Single Family - Detached,14679,276,0.0188,2030,92154
3373,14078,Multifamily,14569,491,0.0337,2030,92154
3374,1463,Mobile Home,1615,152,0.09412,2030,92154
3375,29944,Total Units,30863,919,0.02978,2030,92154
3376,14419,Single Family - Detached,14677,258,0.01758,2035,92154
3377,17895,Multifamily,18455,560,0.03034,2035,92154
3378,1135,Mobile Home,1281,146,0.11397,2035,92154
3379,33449,Total Units,34413,964,0.02801,2035,92154
3380,14550,Single Family - Detached,14849,299,0.02014,2040,92154
3381,18877,Multifamily,19536,659,0.03373,2040,92154
3382,850,Mobile Home,944,94,0.09958,2040,92154
3383,34277,Total Units,35329,1052,0.02978,2040,92154
3384,14626,Single Family - Detached,14956,330,0.02206,2045,92154
3385,19358,Multifamily,20095,737,0.03668,2045,92154
3386,846,Mobile Home,944,98,0.10381,2045,92154
3387,34830,Total Units,35995,1165,0.03237,2045,92154
3388,14635,Single Family - Detached,14970,335,0.02238,2050,92154
3389,19501,Multifamily,20265,764,0.0377,2050,92154
3390,829,Mobile Home,944,115,0.12182,2050,92154
3391,34965,Total Units,36179,1214,0.03356,2050,92154
3392,22,Single Family - Detached,32,10,0.3125,2012,92155
3393,0,Multifamily,0,0,,2012,92155
3394,0,Mobile Home,0,0,,2012,92155
3395,22,Total Units,32,10,0.3125,2012,92155
3396,22,Single Family - Detached,32,10,0.3125,2020,92155
3397,0,Multifamily,0,0,,2020,92155
3398,0,Mobile Home,0,0,,2020,92155
3399,22,Total Units,32,10,0.3125,2020,92155
3400,22,Single Family - Detached,32,10,0.3125,2025,92155
3401,0,Multifamily,0,0,,2025,92155
3402,0,Mobile Home,0,0,,2025,92155
3403,22,Total Units,32,10,0.3125,2025,92155
3404,22,Single Family - Detached,32,10,0.3125,2030,92155
3405,0,Multifamily,0,0,,2030,92155
3406,0,Mobile Home,0,0,,2030,92155
3407,22,Total Units,32,10,0.3125,2030,92155
3408,22,Single Family - Detached,32,10,0.3125,2035,92155
3409,0,Multifamily,0,0,,2035,92155
3410,0,Mobile Home,0,0,,2035,92155
3411,22,Total Units,32,10,0.3125,2035,92155
3412,22,Single Family - Detached,32,10,0.3125,2040,92155
3413,0,Multifamily,0,0,,2040,92155
3414,0,Mobile Home,0,0,,2040,92155
3415,22,Total Units,32,10,0.3125,2040,92155
3416,22,Single Family - Detached,32,10,0.3125,2045,92155
3417,0,Multifamily,0,0,,2045,92155
3418,0,Mobile Home,0,0,,2045,92155
3419,22,Total Units,32,10,0.3125,2045,92155
3420,22,Single Family - Detached,32,10,0.3125,2050,92155
3421,0,Multifamily,0,0,,2050,92155
3422,0,Mobile Home,0,0,,2050,92155
3423,22,Total Units,32,10,0.3125,2050,92155
3424,0,Single Family - Detached,0,0,,2012,92161
3425,0,Multifamily,0,0,,2012,92161
3426,0,Mobile Home,0,0,,2012,92161
3427,0,Total Units,0,0,,2012,92161
3428,0,Single Family - Detached,0,0,,2020,92161
3429,0,Multifamily,0,0,,2020,92161
3430,0,Mobile Home,0,0,,2020,92161
3431,0,Total Units,0,0,,2020,92161
3432,0,Single Family - Detached,0,0,,2025,92161
3433,0,Multifamily,0,0,,2025,92161
3434,0,Mobile Home,0,0,,2025,92161
3435,0,Total Units,0,0,,2025,92161
3436,0,Single Family - Detached,0,0,,2030,92161
3437,0,Multifamily,0,0,,2030,92161
3438,0,Mobile Home,0,0,,2030,92161
3439,0,Total Units,0,0,,2030,92161
3440,0,Single Family - Detached,0,0,,2035,92161
3441,0,Multifamily,0,0,,2035,92161
3442,0,Mobile Home,0,0,,2035,92161
3443,0,Total Units,0,0,,2035,92161
3444,0,Single Family - Detached,0,0,,2040,92161
3445,0,Multifamily,0,0,,2040,92161
3446,0,Mobile Home,0,0,,2040,92161
3447,0,Total Units,0,0,,2040,92161
3448,0,Single Family - Detached,0,0,,2045,92161
3449,0,Multifamily,0,0,,2045,92161
3450,0,Mobile Home,0,0,,2045,92161
3451,0,Total Units,0,0,,2045,92161
3452,0,Single Family - Detached,0,0,,2050,92161
3453,0,Multifamily,0,0,,2050,92161
3454,0,Mobile Home,0,0,,2050,92161
3455,0,Total Units,0,0,,2050,92161
3456,2667,Single Family - Detached,2678,11,0.00411,2012,92173
3457,4497,Multifamily,4617,120,0.02599,2012,92173
3458,476,Mobile Home,487,11,0.02259,2012,92173
3459,7640,Total Units,7782,142,0.01825,2012,92173
3460,2791,Single Family - Detached,2810,19,0.00676,2020,92173
3461,4582,Multifamily,4696,114,0.02428,2020,92173
3462,477,Mobile Home,487,10,0.02053,2020,92173
3463,7850,Total Units,7993,143,0.01789,2020,92173
3464,2794,Single Family - Detached,2807,13,0.00463,2025,92173
3465,4751,Multifamily,4851,100,0.02061,2025,92173
3466,477,Mobile Home,487,10,0.02053,2025,92173
3467,8022,Total Units,8145,123,0.0151,2025,92173
3468,2904,Single Family - Detached,2926,22,0.00752,2030,92173
3469,5386,Multifamily,5496,110,0.02001,2030,92173
3470,474,Mobile Home,487,13,0.02669,2030,92173
3471,8764,Total Units,8909,145,0.01628,2030,92173
3472,2803,Single Family - Detached,2816,13,0.00462,2035,92173
3473,5851,Multifamily,5959,108,0.01812,2035,92173
3474,474,Mobile Home,487,13,0.02669,2035,92173
3475,9128,Total Units,9262,134,0.01447,2035,92173
3476,3055,Single Family - Detached,3074,19,0.00618,2040,92173
3477,6231,Multifamily,6366,135,0.02121,2040,92173
3478,466,Mobile Home,478,12,0.0251,2040,92173
3479,9752,Total Units,9918,166,0.01674,2040,92173
3480,3045,Single Family - Detached,3068,23,0.0075,2045,92173
3481,6667,Multifamily,6806,139,0.02042,2045,92173
3482,290,Mobile Home,301,11,0.03654,2045,92173
3483,10002,Total Units,10175,173,0.017,2045,92173
3484,3050,Single Family - Detached,3074,24,0.00781,2050,92173
3485,6764,Multifamily,6909,145,0.02099,2050,92173
3486,284,Mobile Home,301,17,0.05648,2050,92173
3487,10098,Total Units,10284,186,0.01809,2050,92173
3488,0,Single Family - Detached,0,0,,2012,92182
3489,0,Multifamily,0,0,,2012,92182
3490,0,Mobile Home,0,0,,2012,92182
3491,0,Total Units,0,0,,2012,92182
3492,0,Single Family - Detached,0,0,,2020,92182
3493,0,Multifamily,0,0,,2020,92182
3494,0,Mobile Home,0,0,,2020,92182
3495,0,Total Units,0,0,,2020,92182
3496,0,Single Family - Detached,0,0,,2025,92182
3497,0,Multifamily,0,0,,2025,92182
3498,0,Mobile Home,0,0,,2025,92182
3499,0,Total Units,0,0,,2025,92182
3500,0,Single Family - Detached,0,0,,2030,92182
3501,0,Multifamily,0,0,,2030,92182
3502,0,Mobile Home,0,0,,2030,92182
3503,0,Total Units,0,0,,2030,92182
3504,0,Single Family - Detached,0,0,,2035,92182
3505,0,Multifamily,0,0,,2035,92182
3506,0,Mobile Home,0,0,,2035,92182
3507,0,Total Units,0,0,,2035,92182
3508,0,Single Family - Detached,0,0,,2040,92182
3509,0,Multifamily,0,0,,2040,92182
3510,0,Mobile Home,0,0,,2040,92182
3511,0,Total Units,0,0,,2040,92182
3512,0,Single Family - Detached,0,0,,2045,92182
3513,0,Multifamily,0,0,,2045,92182
3514,0,Mobile Home,0,0,,2045,92182
3515,0,Total Units,0,0,,2045,92182
3516,0,Single Family - Detached,0,0,,2050,92182
3517,0,Multifamily,0,0,,2050,92182
3518,0,Mobile Home,0,0,,2050,92182
3519,0,Total Units,0,0,,2050,92182
3520,0,Single Family - Detached,0,0,,2012,92259
3521,0,Multifamily,0,0,,2012,92259
3522,0,Mobile Home,0,0,,2012,92259
3523,0,Total Units,0,0,,2012,92259
3524,0,Single Family - Detached,0,0,,2020,92259
3525,0,Multifamily,0,0,,2020,92259
3526,0,Mobile Home,0,0,,2020,92259
3527,0,Total Units,0,0,,2020,92259
3528,0,Single Family - Detached,0,0,,2025,92259
3529,0,Multifamily,0,0,,2025,92259
3530,0,Mobile Home,0,0,,2025,92259
3531,0,Total Units,0,0,,2025,92259
3532,0,Single Family - Detached,0,0,,2030,92259
3533,0,Multifamily,0,0,,2030,92259
3534,0,Mobile Home,0,0,,2030,92259
3535,0,Total Units,0,0,,2030,92259
3536,0,Single Family - Detached,0,0,,2035,92259
3537,0,Multifamily,0,0,,2035,92259
3538,0,Mobile Home,0,0,,2035,92259
3539,0,Total Units,0,0,,2035,92259
3540,0,Single Family - Detached,0,0,,2040,92259
3541,0,Multifamily,0,0,,2040,92259
3542,0,Mobile Home,0,0,,2040,92259
3543,0,Total Units,0,0,,2040,92259
3544,0,Single Family - Detached,0,0,,2045,92259
3545,0,Multifamily,0,0,,2045,92259
3546,0,Mobile Home,0,0,,2045,92259
3547,0,Total Units,0,0,,2045,92259
3548,0,Single Family - Detached,0,0,,2050,92259
3549,0,Multifamily,0,0,,2050,92259
3550,0,Mobile Home,0,0,,2050,92259
3551,0,Total Units,0,0,,2050,92259
3552,200,Single Family - Detached,211,11,0.05213,2012,92536
3553,0,Multifamily,0,0,,2012,92536
3554,0,Mobile Home,0,0,,2012,92536
3555,200,Total Units,211,11,0.05213,2012,92536
3556,201,Single Family - Detached,212,11,0.05189,2020,92536
3557,0,Multifamily,0,0,,2020,92536
3558,0,Mobile Home,0,0,,2020,92536
3559,201,Total Units,212,11,0.05189,2020,92536
3560,202,Single Family - Detached,212,10,0.04717,2025,92536
3561,0,Multifamily,0,0,,2025,92536
3562,0,Mobile Home,0,0,,2025,92536
3563,202,Total Units,212,10,0.04717,2025,92536
3564,203,Single Family - Detached,213,10,0.04695,2030,92536
3565,0,Multifamily,0,0,,2030,92536
3566,0,Mobile Home,0,0,,2030,92536
3567,203,Total Units,213,10,0.04695,2030,92536
3568,229,Single Family - Detached,240,11,0.04583,2035,92536
3569,0,Multifamily,0,0,,2035,92536
3570,0,Mobile Home,0,0,,2035,92536
3571,229,Total Units,240,11,0.04583,2035,92536
3572,228,Single Family - Detached,240,12,0.05,2040,92536
3573,0,Multifamily,0,0,,2040,92536
3574,0,Mobile Home,0,0,,2040,92536
3575,228,Total Units,240,12,0.05,2040,92536
3576,228,Single Family - Detached,240,12,0.05,2045,92536
3577,0,Multifamily,0,0,,2045,92536
3578,0,Mobile Home,0,0,,2045,92536
3579,228,Total Units,240,12,0.05,2045,92536
3580,228,Single Family - Detached,240,12,0.05,2050,92536
3581,0,Multifamily,0,0,,2050,92536
3582,0,Mobile Home,0,0,,2050,92536
3583,228,Total Units,240,12,0.05,2050,92536
3584,1181,Single Family - Detached,1234,53,0.04295,2012,92672
3585,0,Multifamily,0,0,,2012,92672
3586,0,Mobile Home,0,0,,2012,92672
3587,1181,Total Units,1234,53,0.04295,2012,92672
3588,1179,Single Family - Detached,1234,55,0.04457,2020,92672
3589,0,Multifamily,0,0,,2020,92672
3590,0,Mobile Home,0,0,,2020,92672
3591,1179,Total Units,1234,55,0.04457,2020,92672
3592,1181,Single Family - Detached,1234,53,0.04295,2025,92672
3593,0,Multifamily,0,0,,2025,92672
3594,0,Mobile Home,0,0,,2025,92672
3595,1181,Total Units,1234,53,0.04295,2025,92672
3596,1181,Single Family - Detached,1234,53,0.04295,2030,92672
3597,0,Multifamily,0,0,,2030,92672
3598,0,Mobile Home,0,0,,2030,92672
3599,1181,Total Units,1234,53,0.04295,2030,92672
3600,1182,Single Family - Detached,1234,52,0.04214,2035,92672
3601,0,Multifamily,0,0,,2035,92672
3602,0,Mobile Home,0,0,,2035,92672
3603,1182,Total Units,1234,52,0.04214,2035,92672
3604,1179,Single Family - Detached,1234,55,0.04457,2040,92672
3605,0,Multifamily,0,0,,2040,92672
3606,0,Mobile Home,0,0,,2040,92672
3607,1179,Total Units,1234,55,0.04457,2040,92672
3608,1177,Single Family - Detached,1234,57,0.04619,2045,92672
3609,0,Multifamily,0,0,,2045,92672
3610,0,Mobile Home,0,0,,2045,92672
3611,1177,Total Units,1234,57,0.04619,2045,92672
3612,1177,Single Family - Detached,1234,57,0.04619,2050,92672
3613,0,Multifamily,0,0,,2050,92672
3614,0,Mobile Home,0,0,,2050,92672
3615,1177,Total Units,1234,57,0.04619,2050,92672
